Name,Team,Position,Dropped,Added,Total,Date,Net
Michael Kidd-Gilchrist,CHA , SF,174,14468,14650,2016-10-27,14294
Sergio Rodriguez,PHI , PG,167,11868,12036,2016-10-27,11701
Roy Hibbert,CHA , C,140,11525,11666,2016-10-27,11385
Jonathon Simmons,SA ," SG,SF",2097,7036,9133,2016-10-27,4939
Joe Johnson,UTA ," SG,SF",360,8676,9038,2016-10-27,8316
Justin Hamilton,BKN ," PF,C",108,8611,8719,2016-10-27,8503
J.J. Barea,DAL ," PG,SG",113,5818,5931,2016-10-27,5705
Matt Barnes,SAC ," SG,SF",565,4003,4570,2016-10-27,3438
Ty Lawson,SAC , PG,908,3140,4049,2016-10-27,2232
Allen Crabbe,POR ," PG,SG",760,3276,4039,2016-10-27,2516
Wade Baldwin IV,MEM , PG,72,3802,3874,2016-10-27,3730
Tim Frazier,NO ," PG,SG",158,3338,3504,2016-10-27,3180
Mirza Teletovic,MIL ," SF,PF",2895,359,3262,2016-10-27,-2536
Tyler Johnson,MIA ," PG,SG",139,2851,2991,2016-10-27,2712
Buddy Hield,NO , SG,2769,163,2951,2016-10-27,-2606
Willie Cauley-Stein,SAC ," PF,C",2540,398,2940,2016-10-27,-2142
Patty Mills,SA , PG,777,2118,2896,2016-10-27,1341
Marcus Morris,DET ," SF,PF",222,2647,2876,2016-10-27,2425
Rondae Hollis-Jefferson,BKN ," SG,SF",2658,174,2846,2016-10-27,-2484
Terrence Jones,NO ," SF,PF",2556,242,2810,2016-10-27,-2314
Justise Winslow,MIA ," SF,PF",139,2646,2795,2016-10-27,2507
Luol Deng,LAL ," SF,PF",2627,160,2794,2016-10-27,-2467
Jamal Murray,DEN , SG,2714,71,2790,2016-10-27,-2643
Bojan Bogdanovic,BKN ," SG,SF",217,2535,2759,2016-10-27,2318
Cody Zeller,CHA ," PF,C",297,2419,2718,2016-10-27,2122
Will Barton,DEN ," SG,SF",359,2314,2680,2016-10-27,1955
Courtney Lee,NY ," SG,SF",2459,179,2643,2016-10-27,-2280
Nerlens Noel,PHI ," PF,C",2338,247,2607,2016-10-27,-2091
Tony Parker,SA , PG,1819,770,2596,2016-10-27,-1049
Patrick Beverley,HOU ," PG,SG",2390,158,2552,2016-10-27,-2232
Joakim Noah,NY ," PF,C",2331,179,2526,2016-10-27,-2152
Al Jefferson,IND ," PF,C",2081,435,2523,2016-10-27,-1646
Stanley Johnson,DET ," SG,SF",2412,62,2476,2016-10-27,-2350
Ish Smith,DET , PG,1812,616,2437,2016-10-27,-1196
Evan Turner,POR ," SG,SF",1895,525,2428,2016-10-27,-1370
Danny Green,SA ," SG,SF",2044,183,2233,2016-10-27,-1861
Marcus Smart,BOS , PG,2015,153,2176,2016-10-27,-1862
Mason Plumlee,POR ," PF,C",1472,606,2095,2016-10-27,-866
Timofey Mozgov,LAL , C,415,1678,2095,2016-10-27,1263
Deron Williams,DAL , PG,114,1963,2089,2016-10-27,1849
Brandon Ingram,LAL ," SG,SF",1623,391,2034,2016-10-27,-1232
Dario Saric,PHI ," SF,PF",1863,148,2023,2016-10-27,-1715
Joe Harris,BKN , SG,49,1965,2014,2016-10-27,1916
Lou Williams,LAL ," PG,SG",1391,603,2004,2016-10-27,-788
Al-Farouq Aminu,POR ," SF,PF",1636,357,2003,2016-10-27,-1279
Jahlil Okafor,PHI , C,1864,100,1985,2016-10-27,-1764
Kentavious Caldwell-Pope,DET , SG,1720,191,1923,2016-10-27,-1529
Jared Sullinger,TOR ," PF,C",1786,126,1914,2016-10-27,-1660
Seth Curry,DAL ," PG,SG",1029,862,1897,2016-10-27,-167
Matthew Dellavedova,MIL ," PG,SG",1546,339,1893,2016-10-27,-1207
Roy Hibbert,CHA , C,3906,4825,8734,2016-10-28,919
T.J. Warren,PHO , SF,319,8347,8667,2016-10-28,8028
Tim Hardaway Jr.,ATL ," SG,SF",119,7343,7462,2016-10-28,7224
Maurice Harkless,POR , SF,147,7169,7317,2016-10-28,7022
Jonathon Simmons,SA ," SG,SF",4787,1457,6245,2016-10-28,-3330
Joe Johnson,UTA ," SG,SF",1087,5114,6203,2016-10-28,4027
Sergio Rodriguez,PHI , PG,182,4748,4932,2016-10-28,4566
Dewayne Dedmon,SA , C,66,4803,4869,2016-10-28,4737
Michael Kidd-Gilchrist,CHA , SF,549,4154,4709,2016-10-28,3605
Justin Hamilton,BKN ," PF,C",388,3796,4184,2016-10-28,3408
J.J. Barea,DAL ," PG,SG",510,3061,3571,2016-10-28,2551
Allen Crabbe,POR ," PG,SG",680,2871,3554,2016-10-28,2191
Ty Lawson,SAC , PG,602,2809,3416,2016-10-28,2207
Evan Turner,POR ," SG,SF",3154,190,3352,2016-10-28,-2964
Cody Zeller,CHA ," PF,C",235,3062,3297,2016-10-28,2827
Thabo Sefolosha,ATL ," SG,SF",58,3163,3221,2016-10-28,3105
Willie Cauley-Stein,SAC ," PF,C",2981,194,3180,2016-10-28,-2787
Marcus Morris,DET ," SF,PF",178,2965,3153,2016-10-28,2787
Al-Farouq Aminu,POR ," SF,PF",2804,160,2975,2016-10-28,-2644
Tim Frazier,NO ," PG,SG",144,2799,2947,2016-10-28,2655
Alex Len,PHO ," PF,C",2488,157,2653,2016-10-28,-2331
Tony Parker,SA , PG,2046,423,2479,2016-10-28,-1623
Al Jefferson,IND ," PF,C",2199,258,2466,2016-10-28,-1941
Brandon Ingram,LAL ," SG,SF",2168,271,2458,2016-10-28,-1897
Terrence Jones,NO ," SF,PF",2287,164,2457,2016-10-28,-2123
Buddy Hield,NO , SG,2272,157,2449,2016-10-28,-2115
Bojan Bogdanovic,BKN ," SG,SF",988,1428,2420,2016-10-28,440
Will Barton,DEN ," SG,SF",208,2168,2391,2016-10-28,1960
Trevor Booker,BKN , PF,131,2235,2366,2016-10-28,2104
Rondae Hollis-Jefferson,BKN ," SG,SF",2140,184,2333,2016-10-28,-1956
Taj Gibson,CHI ," PF,C",212,1959,2175,2016-10-28,1747
Seth Curry,DAL ," PG,SG",1611,475,2092,2016-10-28,-1136
Wade Baldwin IV,MEM , PG,162,1905,2067,2016-10-28,1743
Tyler Johnson,MIA ," PG,SG",353,1708,2062,2016-10-28,1355
Lance Stephenson,NO ," SG,SF",68,1923,1992,2016-10-28,1855
Kentavious Caldwell-Pope,DET , SG,1795,144,1956,2016-10-28,-1651
Matt Barnes,SAC ," SG,SF",1447,489,1937,2016-10-28,-958
Timofey Mozgov,LAL , C,459,1332,1795,2016-10-28,873
JaMychal Green,MEM , PF,183,1556,1744,2016-10-28,1373
Bobby Portis,CHI ," PF,C",1707,24,1734,2016-10-28,-1683
Mirza Teletovic,MIL ," SF,PF",1443,269,1715,2016-10-28,-1174
Patty Mills,SA , PG,938,740,1682,2016-10-28,-198
Trey Lyles,UTA , PF,1612,54,1669,2016-10-28,-1558
Mason Plumlee,POR ," PF,C",280,1373,1661,2016-10-28,1093
Nerlens Noel,PHI ," PF,C",1364,275,1654,2016-10-28,-1089
Stanley Johnson,DET ," SG,SF",1586,41,1634,2016-10-28,-1545
Patrick Beverley,HOU ," PG,SG",1453,130,1584,2016-10-28,-1323
Courtney Lee,NY ," SG,SF",1402,144,1557,2016-10-28,-1258
Jamal Crawford,LAC ," SG,SF",658,879,1549,2016-10-28,221
James Ennis III,MEM ," SG,SF",71,1476,1547,2016-10-28,1405
T.J. Warren,PHO , SF,195,11696,11896,2016-10-29,11501
Lance Stephenson,NO ," SG,SF",707,7504,8211,2016-10-29,6797
Trevor Booker,BKN , PF,220,6673,6893,2016-10-29,6453
Roy Hibbert,CHA , C,6151,487,6641,2016-10-29,-5664
Andre Roberson,OKC ," SG,SF",94,4939,5033,2016-10-29,4845
Tim Hardaway Jr.,ATL ," SG,SF",1334,3096,4430,2016-10-29,1762
Terrence Jones,NO ," SF,PF",4298,104,4404,2016-10-29,-4194
Marcus Morris,DET ," SF,PF",142,4095,4244,2016-10-29,3953
Rondae Hollis-Jefferson,BKN ," SG,SF",3572,212,3793,2016-10-29,-3360
Sergio Rodriguez,PHI , PG,410,3299,3711,2016-10-29,2889
Dewayne Dedmon,SA , C,205,3491,3696,2016-10-29,3286
Michael Kidd-Gilchrist,CHA , SF,2465,1194,3664,2016-10-29,-1271
Tim Frazier,NO ," PG,SG",213,3302,3523,2016-10-29,3089
J.J. Barea,DAL ," PG,SG",454,2875,3331,2016-10-29,2421
Joe Johnson,UTA ," SG,SF",904,2342,3250,2016-10-29,1438
James Ennis III,MEM ," SG,SF",94,3152,3246,2016-10-29,3058
Al Jefferson,IND ," PF,C",3022,152,3185,2016-10-29,-2870
Buddy Hield,NO , SG,2911,149,3069,2016-10-29,-2762
Brandon Ingram,LAL ," SG,SF",2836,157,3014,2016-10-29,-2679
Lou Williams,LAL ," PG,SG",270,2588,2859,2016-10-29,2318
Jonathon Simmons,SA ," SG,SF",2226,551,2784,2016-10-29,-1675
Justin Hamilton,BKN ," PF,C",1171,1516,2688,2016-10-29,345
Cody Zeller,CHA ," PF,C",672,1895,2569,2016-10-29,1223
Alex Len,PHO ," PF,C",2414,116,2536,2016-10-29,-2298
Ty Lawson,SAC , PG,817,1544,2364,2016-10-29,727
Dario Saric,PHI ," SF,PF",2093,203,2304,2016-10-29,-1890
Mirza Teletovic,MIL ," SF,PF",2011,275,2288,2016-10-29,-1736
Tony Parker,SA , PG,1950,312,2272,2016-10-29,-1638
Bojan Bogdanovic,BKN ," SG,SF",1442,809,2257,2016-10-29,-633
Sean Kilpatrick,BKN ," PG,SG",171,2038,2209,2016-10-29,1867
Maurice Harkless,POR , SF,803,1386,2190,2016-10-29,583
Will Barton,DEN ," SG,SF",379,1785,2175,2016-10-29,1406
Thabo Sefolosha,ATL ," SG,SF",476,1676,2152,2016-10-29,1200
Patty Mills,SA , PG,304,1797,2103,2016-10-29,1493
Mike Muscala,ATL ," PF,C",94,1965,2059,2016-10-29,1871
JaMychal Green,MEM , PF,285,1738,2027,2016-10-29,1453
Allen Crabbe,POR ," PG,SG",609,1405,2018,2016-10-29,796
Bismack Biyombo,ORL ," PF,C",1786,176,1966,2016-10-29,-1610
Evan Turner,POR ," SG,SF",1745,198,1954,2016-10-29,-1547
Kentavious Caldwell-Pope,DET , SG,1703,229,1951,2016-10-29,-1474
Al-Farouq Aminu,POR ," SF,PF",1735,159,1901,2016-10-29,-1576
Wade Baldwin IV,MEM , PG,476,1411,1888,2016-10-29,935
Taj Gibson,CHI ," PF,C",238,1640,1885,2016-10-29,1402
Jamal Crawford,LAC ," SG,SF",344,1521,1872,2016-10-29,1177
Seth Curry,DAL ," PG,SG",1662,201,1865,2016-10-29,-1461
Tyler Johnson,MIA ," PG,SG",315,1510,1826,2016-10-29,1195
Ish Smith,DET , PG,285,1490,1780,2016-10-29,1205
Tyson Chandler,PHO , C,176,1598,1776,2016-10-29,1422
Timofey Mozgov,LAL , C,442,1322,1767,2016-10-29,880
Willie Cauley-Stein,SAC ," PF,C",1528,108,1638,2016-10-29,-1420
Trevor Booker,BKN , PF,192,19248,19443,2016-10-30,19056
T.J. Warren,PHO , SF,136,9500,9641,2016-10-30,9364
Mike Muscala,ATL ," PF,C",125,8068,8193,2016-10-30,7943
Matt Barnes,SAC ," SG,SF",234,4642,4878,2016-10-30,4408
James Ennis III,MEM ," SG,SF",383,4181,4564,2016-10-30,3798
Terrence Jones,NO ," SF,PF",4399,48,4453,2016-10-30,-4351
Patty Mills,SA , PG,412,3830,4244,2016-10-30,3418
Mirza Teletovic,MIL ," SF,PF",4067,142,4216,2016-10-30,-3925
Michael Kidd-Gilchrist,CHA , SF,3747,390,4150,2016-10-30,-3357
Tyson Chandler,PHO , C,162,3879,4043,2016-10-30,3717
Rondae Hollis-Jefferson,BKN ," SG,SF",3603,221,3836,2016-10-30,-3382
Roy Hibbert,CHA , C,3574,219,3794,2016-10-30,-3355
Andre Roberson,OKC ," SG,SF",748,2571,3319,2016-10-30,1823
Bojan Bogdanovic,BKN ," SG,SF",253,3004,3266,2016-10-30,2751
Joe Johnson,UTA ," SG,SF",1718,1512,3240,2016-10-30,-206
Matthew Dellavedova,MIL ," PG,SG",270,2945,3224,2016-10-30,2675
J.J. Barea,DAL ," PG,SG",533,2630,3163,2016-10-30,2097
Jonathon Simmons,SA ," SG,SF",2709,438,3158,2016-10-30,-2271
Sean Kilpatrick,BKN ," PG,SG",208,2835,3043,2016-10-30,2627
Ty Lawson,SAC , PG,803,2214,3022,2016-10-30,1411
Tony Parker,SA , PG,2539,260,2805,2016-10-30,-2279
Kris Dunn,MIN , PG,1063,1620,2692,2016-10-30,557
Sergio Rodriguez,PHI , PG,345,2330,2683,2016-10-30,1985
Dario Saric,PHI ," SF,PF",2471,180,2657,2016-10-30,-2291
Al Jefferson,IND ," PF,C",2463,126,2598,2016-10-30,-2337
Lou Williams,LAL ," PG,SG",981,1549,2536,2016-10-30,568
Marcus Morris,DET ," SF,PF",525,1927,2464,2016-10-30,1402
Luol Deng,LAL ," SF,PF",1417,1012,2435,2016-10-30,-405
Dewayne Dedmon,SA , C,748,1610,2358,2016-10-30,862
Seth Curry,DAL ," PG,SG",2149,125,2281,2016-10-30,-2024
Bismack Biyombo,ORL ," PF,C",2046,117,2172,2016-10-30,-1929
Thabo Sefolosha,ATL ," SG,SF",286,1874,2160,2016-10-30,1588
Buddy Hield,NO , SG,2019,110,2136,2016-10-30,-1909
Justin Hamilton,BKN ," PF,C",974,1135,2113,2016-10-30,161
Will Barton,DEN ," SG,SF",321,1722,2048,2016-10-30,1401
Lance Stephenson,NO ," SG,SF",1520,499,2019,2016-10-30,-1021
Brandon Ingram,LAL ," SG,SF",1732,242,2000,2016-10-30,-1490
Doug McDermott,CHI , SF,89,1876,1970,2016-10-30,1787
Willie Cauley-Stein,SAC ," PF,C",1773,131,1908,2016-10-30,-1642
Allen Crabbe,POR ," PG,SG",537,1362,1904,2016-10-30,825
Jamal Crawford,LAC ," SG,SF",499,1361,1875,2016-10-30,862
Alex Len,PHO ," PF,C",1646,222,1868,2016-10-30,-1424
Emmanuel Mudiay,DEN , PG,335,1414,1761,2016-10-30,1079
Cody Zeller,CHA ," PF,C",747,957,1706,2016-10-30,210
Timofey Mozgov,LAL , C,862,830,1698,2016-10-30,-32
Jahlil Okafor,PHI , C,1455,226,1696,2016-10-30,-1229
Tim Hardaway Jr.,ATL ," SG,SF",1239,418,1658,2016-10-30,-821
Taj Gibson,CHI ," PF,C",281,1371,1656,2016-10-30,1090
JaMychal Green,MEM , PF,1063,583,1651,2016-10-30,-480
Evan Turner,POR ," SG,SF",1415,202,1624,2016-10-30,-1213
Trevor Booker,BKN , PF,841,10190,11032,2016-10-31,9349
Mike Muscala,ATL ," PF,C",696,8832,9528,2016-10-31,8136
J.J. Barea,DAL ," PG,SG",405,8427,8832,2016-10-31,8022
T.J. Warren,PHO , SF,241,8402,8647,2016-10-31,8161
Tyson Chandler,PHO , C,500,7000,7504,2016-10-31,6500
Patty Mills,SA , PG,432,7055,7491,2016-10-31,6623
Matt Barnes,SAC ," SG,SF",276,5910,6187,2016-10-31,5634
Rondae Hollis-Jefferson,BKN ," SG,SF",3665,333,4000,2016-10-31,-3332
James Ennis III,MEM ," SG,SF",560,3338,3898,2016-10-31,2778
Jonathon Simmons,SA ," SG,SF",3459,375,3846,2016-10-31,-3084
Thabo Sefolosha,ATL ," SG,SF",418,3403,3824,2016-10-31,2985
Roy Hibbert,CHA , C,3422,224,3654,2016-10-31,-3198
Sergio Rodriguez,PHI , PG,373,3274,3653,2016-10-31,2901
Bojan Bogdanovic,BKN ," SG,SF",281,3362,3650,2016-10-31,3081
Michael Kidd-Gilchrist,CHA , SF,3254,323,3586,2016-10-31,-2931
Mirza Teletovic,MIL ," SF,PF",3476,82,3559,2016-10-31,-3394
Seth Curry,DAL ," PG,SG",3365,57,3425,2016-10-31,-3308
Kris Dunn,MIN , PG,1089,2263,3359,2016-10-31,1174
Joe Johnson,UTA ," SG,SF",2050,1289,3354,2016-10-31,-761
Ty Lawson,SAC , PG,811,2479,3296,2016-10-31,1668
Justin Hamilton,BKN ," PF,C",2011,1196,3208,2016-10-31,-815
Andre Roberson,OKC ," SG,SF",865,2185,3050,2016-10-31,1320
Matthew Dellavedova,MIL ," PG,SG",384,2636,3025,2016-10-31,2252
Sean Kilpatrick,BKN ," PG,SG",544,2450,2996,2016-10-31,1906
Tony Parker,SA , PG,2709,225,2942,2016-10-31,-2484
Terrence Jones,NO ," SF,PF",2693,88,2783,2016-10-31,-2605
Will Barton,DEN ," SG,SF",877,1887,2775,2016-10-31,1010
Doug McDermott,CHI , SF,331,2385,2716,2016-10-31,2054
Dewayne Dedmon,SA , C,721,1978,2699,2016-10-31,1257
Allen Crabbe,POR ," PG,SG",409,2232,2646,2016-10-31,1823
Taj Gibson,CHI ," PF,C",202,2304,2514,2016-10-31,2102
Ricky Rubio,MIN , PG,2360,97,2484,2016-10-31,-2263
Luol Deng,LAL ," SF,PF",2152,281,2444,2016-10-31,-1871
Brandon Ingram,LAL ," SG,SF",1901,420,2335,2016-10-31,-1481
Jahlil Okafor,PHI , C,2058,205,2282,2016-10-31,-1853
Al Jefferson,IND ," PF,C",2050,163,2224,2016-10-31,-1887
Tim Hardaway Jr.,ATL ," SG,SF",1775,411,2186,2016-10-31,-1364
Dario Saric,PHI ," SF,PF",1956,186,2153,2016-10-31,-1770
Buddy Hield,NO , SG,1936,189,2135,2016-10-31,-1747
Emmanuel Mudiay,DEN , PG,368,1738,2122,2016-10-31,1370
Nick Young,LAL ," SG,SF",130,1929,2060,2016-10-31,1799
Lou Williams,LAL ," PG,SG",1469,512,1989,2016-10-31,-957
Willie Cauley-Stein,SAC ," PF,C",1718,210,1931,2016-10-31,-1508
Cody Zeller,CHA ," PF,C",628,1279,1908,2016-10-31,651
Alex Len,PHO ," PF,C",1476,408,1891,2016-10-31,-1068
Bismack Biyombo,ORL ," PF,C",1671,191,1872,2016-10-31,-1480
Marcus Morris,DET ," SF,PF",726,1131,1866,2016-10-31,405
Jamal Crawford,LAC ," SG,SF",983,855,1840,2016-10-31,-128
Timofey Mozgov,LAL , C,1066,735,1809,2016-10-31,-331
Ish Smith,DET , PG,747,1024,1780,2016-10-31,277
Matt Barnes,SAC ," SG,SF",856,5618,6476,2016-11-01,4762
Jerami Grant,OKC ," SF,PF",182,6215,6399,2016-11-01,6033
Thabo Sefolosha,ATL ," SG,SF",404,5362,5768,2016-11-01,4958
Kris Dunn,MIN , PG,411,5347,5763,2016-11-01,4936
J.J. Barea,DAL ," PG,SG",616,5105,5728,2016-11-01,4489
Ricky Rubio,MIN , PG,4990,142,5148,2016-11-01,-4848
Patty Mills,SA , PG,997,3696,4696,2016-11-01,2699
Sergio Rodriguez,PHI , PG,217,4412,4636,2016-11-01,4195
Cody Zeller,CHA ," PF,C",312,3624,3940,2016-11-01,3312
Ty Lawson,SAC , PG,2616,1151,3772,2016-11-01,-1465
Taj Gibson,CHI ," PF,C",137,3421,3570,2016-11-01,3284
Trevor Booker,BKN , PF,1273,2206,3484,2016-11-01,933
Rondae Hollis-Jefferson,BKN ," SG,SF",2905,354,3267,2016-11-01,-2551
Isaiah Canaan,CHI , PG,88,3131,3219,2016-11-01,3043
Andre Roberson,OKC ," SG,SF",390,2675,3066,2016-11-01,2285
Mike Muscala,ATL ," PF,C",1116,1917,3033,2016-11-01,801
Jonathon Simmons,SA ," SG,SF",2735,277,3017,2016-11-01,-2458
Terrence Jones,NO ," SF,PF",2915,85,3004,2016-11-01,-2830
Bojan Bogdanovic,BKN ," SG,SF",297,2595,2896,2016-11-01,2298
Michael Carter-Williams,CHI , PG,2763,26,2795,2016-11-01,-2737
Allen Crabbe,POR ," PG,SG",1012,1736,2754,2016-11-01,724
Joe Johnson,UTA ," SG,SF",1593,1090,2694,2016-11-01,-503
Tyson Chandler,PHO , C,1099,1541,2642,2016-11-01,442
Dewayne Dedmon,SA , C,1467,1155,2624,2016-11-01,-312
Dario Saric,PHI ," SF,PF",915,1682,2604,2016-11-01,767
James Ennis III,MEM ," SG,SF",897,1637,2536,2016-11-01,740
T.J. Warren,PHO , SF,281,2243,2530,2016-11-01,1962
Brandon Ingram,LAL ," SG,SF",2022,453,2488,2016-11-01,-1569
Matthew Dellavedova,MIL ," PG,SG",316,2155,2480,2016-11-01,1839
Will Barton,DEN ," SG,SF",1546,764,2317,2016-11-01,-782
Timofey Mozgov,LAL , C,1705,600,2311,2016-11-01,-1105
Justin Hamilton,BKN ," PF,C",1984,299,2284,2016-11-01,-1685
Michael Kidd-Gilchrist,CHA , SF,1621,553,2194,2016-11-01,-1068
Mirza Teletovic,MIL ," SF,PF",1911,97,2012,2016-11-01,-1814
Tony Snell,MIL ," SG,SF",73,1919,1992,2016-11-01,1846
Tyler Johnson,MIA ," PG,SG",440,1521,1965,2016-11-01,1081
Sean Kilpatrick,BKN ," PG,SG",591,1319,1911,2016-11-01,728
Tim Hardaway Jr.,ATL ," SG,SF",1775,85,1861,2016-11-01,-1690
Kentavious Caldwell-Pope,DET , SG,201,1636,1843,2016-11-01,1435
Lance Stephenson,NO ," SG,SF",1353,409,1763,2016-11-01,-944
Jahlil Okafor,PHI , C,1249,447,1721,2016-11-01,-802
Jamal Crawford,LAC ," SG,SF",500,1187,1692,2016-11-01,687
Marcus Morris,DET ," SF,PF",230,1446,1689,2016-11-01,1216
Bismack Biyombo,ORL ," PF,C",1470,202,1686,2016-11-01,-1268
JaMychal Green,MEM , PF,1305,364,1679,2016-11-01,-941
Roy Hibbert,CHA , C,1344,321,1668,2016-11-01,-1023
Al Jefferson,IND ," PF,C",1458,168,1635,2016-11-01,-1290
Willie Cauley-Stein,SAC ," PF,C",1479,137,1618,2016-11-01,-1342
Buddy Hield,NO , SG,1391,208,1607,2016-11-01,-1183
Marcus Smart,BOS , PG,613,970,1587,2016-11-01,357
Tyler Johnson,MIA ," PG,SG",220,8566,8789,2016-11-02,8346
Sean Kilpatrick,BKN ," PG,SG",305,5473,5780,2016-11-02,5168
Jerami Grant,OKC ," SF,PF",531,4919,5450,2016-11-02,4388
Matthew Dellavedova,MIL ," PG,SG",208,4247,4465,2016-11-02,4039
Sergio Rodriguez,PHI , PG,328,3877,4210,2016-11-02,3549
C.J. Miles,IND ," SG,SF",109,4000,4110,2016-11-02,3891
Will Barton,DEN ," SG,SF",3436,547,3997,2016-11-02,-2889
Timofey Mozgov,LAL , C,3593,128,3728,2016-11-02,-3465
Kris Dunn,MIN , PG,261,3220,3486,2016-11-02,2959
Trevor Booker,BKN , PF,2096,1281,3388,2016-11-02,-815
Brandon Ingram,LAL ," SG,SF",3003,286,3301,2016-11-02,-2717
Ty Lawson,SAC , PG,2392,788,3193,2016-11-02,-1604
Andre Roberson,OKC ," SG,SF",674,2495,3170,2016-11-02,1821
J.J. Barea,DAL ," PG,SG",1070,2084,3157,2016-11-02,1014
Cody Zeller,CHA ," PF,C",638,2443,3086,2016-11-02,1805
Dario Saric,PHI ," SF,PF",330,2660,2996,2016-11-02,2330
Marcus Morris,DET ," SF,PF",170,2772,2953,2016-11-02,2602
Thabo Sefolosha,ATL ," SG,SF",853,2059,2914,2016-11-02,1206
Ricky Rubio,MIN , PG,2690,176,2887,2016-11-02,-2514
Tony Snell,MIL ," SG,SF",127,2718,2847,2016-11-02,2591
Amir Johnson,BOS ," PF,C",261,2560,2821,2016-11-02,2299
Rondae Hollis-Jefferson,BKN ," SG,SF",2413,318,2737,2016-11-02,-2095
Terrence Jones,NO ," SF,PF",2575,124,2705,2016-11-02,-2451
Matt Barnes,SAC ," SG,SF",1288,1342,2638,2016-11-02,54
Allen Crabbe,POR ," PG,SG",2143,482,2631,2016-11-02,-1661
Joe Johnson,UTA ," SG,SF",1759,847,2612,2016-11-02,-912
Jonathon Simmons,SA ," SG,SF",2418,170,2597,2016-11-02,-2248
Patty Mills,SA , PG,1375,1221,2596,2016-11-02,-154
Mike Muscala,ATL ," PF,C",1406,1068,2477,2016-11-02,-338
Dion Waiters,MIA ," SG,SF",222,2041,2268,2016-11-02,1819
Joakim Noah,NY ," PF,C",1406,812,2226,2016-11-02,-594
Taj Gibson,CHI ," PF,C",135,2065,2214,2016-11-02,1930
Tyson Chandler,PHO , C,561,1614,2180,2016-11-02,1053
Robert Covington,PHI ," SF,PF",1952,197,2156,2016-11-02,-1755
Kentavious Caldwell-Pope,DET , SG,172,1894,2076,2016-11-02,1722
Tim Frazier,NO ," PG,SG",288,1749,2047,2016-11-02,1461
Michael Kidd-Gilchrist,CHA , SF,1260,747,2023,2016-11-02,-513
Justin Hamilton,BKN ," PF,C",1721,252,1974,2016-11-02,-1469
Dewayne Dedmon,SA , C,1673,283,1960,2016-11-02,-1390
Ersan Ilyasova,PHI ," SF,PF",391,1508,1903,2016-11-02,1117
T.J. Warren,PHO , SF,182,1703,1900,2016-11-02,1521
Roy Hibbert,CHA , C,1606,269,1882,2016-11-02,-1337
James Ennis III,MEM ," SG,SF",1253,626,1880,2016-11-02,-627
Marcus Smart,BOS , PG,573,1275,1851,2016-11-02,702
Buddy Hield,NO , SG,1330,503,1838,2016-11-02,-827
Lance Stephenson,NO ," SG,SF",1194,570,1768,2016-11-02,-624
Lou Williams,LAL ," PG,SG",454,1286,1744,2016-11-02,832
JaMychal Green,MEM , PF,1315,385,1709,2016-11-02,-930
Bismack Biyombo,ORL ," PF,C",1381,311,1708,2016-11-02,-1070
Jake Layman,POR , PF,119,1551,1670,2016-11-02,1432
Sean Kilpatrick,BKN ," PG,SG",212,17870,18083,2016-11-03,17658
Jaylen Brown,BOS , SF,329,7160,7490,2016-11-03,6831
Amir Johnson,BOS ," PF,C",1104,6145,7250,2016-11-03,5041
Tyson Chandler,PHO , C,253,5538,5794,2016-11-03,5285
Tyler Johnson,MIA ," PG,SG",285,4341,4628,2016-11-03,4056
Will Barton,DEN ," SG,SF",4230,363,4611,2016-11-03,-3867
Alex Len,PHO ," PF,C",256,3948,4206,2016-11-03,3692
James Ennis III,MEM ," SG,SF",333,3866,4205,2016-11-03,3533
Matt Barnes,SAC ," SG,SF",3397,622,4027,2016-11-03,-2775
Trevor Booker,BKN , PF,2758,877,3643,2016-11-03,-1881
Lou Williams,LAL ," PG,SG",239,3369,3613,2016-11-03,3130
Andre Roberson,OKC ," SG,SF",3086,464,3551,2016-11-03,-2622
Matthew Dellavedova,MIL ," PG,SG",1001,2355,3377,2016-11-03,1354
J.J. Barea,DAL ," PG,SG",979,2208,3193,2016-11-03,1229
C.J. Miles,IND ," SG,SF",721,2449,3173,2016-11-03,1728
Marcus Morris,DET ," SF,PF",127,2943,3080,2016-11-03,2816
Jrue Holiday,NO , PG,373,2697,3072,2016-11-03,2324
Brandon Ingram,LAL ," SG,SF",2864,150,3030,2016-11-03,-2714
Rondae Hollis-Jefferson,BKN ," SG,SF",2699,276,2979,2016-11-03,-2423
Marcus Smart,BOS , PG,533,2238,2775,2016-11-03,1705
Timofey Mozgov,LAL , C,2605,84,2693,2016-11-03,-2521
Jerami Grant,OKC ," SF,PF",2322,364,2691,2016-11-03,-1958
T.J. Warren,PHO , SF,78,2530,2624,2016-11-03,2452
Jeremy Lin,BKN ," PG,SG",2452,72,2551,2016-11-03,-2380
Ricky Rubio,MIN , PG,2144,268,2438,2016-11-03,-1876
Joe Johnson,UTA ," SG,SF",1025,1371,2407,2016-11-03,346
Ty Lawson,SAC , PG,1911,487,2406,2016-11-03,-1424
Mike Muscala,ATL ," PF,C",1672,678,2354,2016-11-03,-994
Roy Hibbert,CHA , C,2112,174,2292,2016-11-03,-1938
Joakim Noah,NY ," PF,C",1969,233,2211,2016-11-03,-1736
Tim Hardaway Jr.,ATL ," SG,SF",196,2001,2200,2016-11-03,1805
Kris Dunn,MIN , PG,475,1709,2198,2016-11-03,1234
Patty Mills,SA , PG,923,1198,2126,2016-11-03,275
Cody Zeller,CHA ," PF,C",906,1189,2101,2016-11-03,283
Michael Kidd-Gilchrist,CHA , SF,881,1153,2051,2016-11-03,272
Larry Nance Jr.,LAL , PF,147,1901,2049,2016-11-03,1754
Robert Covington,PHI ," SF,PF",1887,148,2048,2016-11-03,-1739
Thabo Sefolosha,ATL ," SG,SF",963,1061,2026,2016-11-03,98
Jonathon Simmons,SA ," SG,SF",1807,148,1959,2016-11-03,-1659
Sergio Rodriguez,PHI , PG,506,1402,1924,2016-11-03,896
Justin Hamilton,BKN ," PF,C",1728,175,1906,2016-11-03,-1553
JaMychal Green,MEM , PF,277,1565,1851,2016-11-03,1288
Mirza Teletovic,MIL ," SF,PF",1669,167,1844,2016-11-03,-1502
Tony Parker,SA , PG,1652,166,1827,2016-11-03,-1486
Frank Kaminsky,CHA ," PF,C",200,1592,1792,2016-11-03,1392
Dion Waiters,MIA ," SG,SF",272,1503,1780,2016-11-03,1231
Clint Capela,HOU ," PF,C",1628,105,1752,2016-11-03,-1523
Kentavious Caldwell-Pope,DET , SG,175,1524,1713,2016-11-03,1349
Jae Crowder,BOS ," SF,PF",1621,61,1709,2016-11-03,-1560
Jamal Crawford,LAC ," SG,SF",1197,478,1686,2016-11-03,-719
Jaylen Brown,BOS , SF,378,13921,14299,2016-11-04,13543
Terrence Jones,NO ," SF,PF",558,7298,7860,2016-11-04,6740
Sean Kilpatrick,BKN ," PG,SG",689,5634,6327,2016-11-04,4945
C.J. Miles,IND ," SG,SF",388,5433,5822,2016-11-04,5045
Malcolm Brogdon,MIL ," PG,SG",141,5647,5788,2016-11-04,5506
Tyson Chandler,PHO , C,297,3977,4284,2016-11-04,3680
Will Barton,DEN ," SG,SF",3115,433,3561,2016-11-04,-2682
Tyler Johnson,MIA ," PG,SG",359,3102,3467,2016-11-04,2743
Matt Barnes,SAC ," SG,SF",3089,270,3362,2016-11-04,-2819
Andre Roberson,OKC ," SG,SF",2862,75,2942,2016-11-04,-2787
Lou Williams,LAL ," PG,SG",387,2413,2810,2016-11-04,2026
Rondae Hollis-Jefferson,BKN ," SG,SF",1282,1484,2773,2016-11-04,202
Patty Mills,SA , PG,452,2270,2729,2016-11-04,1818
Jerami Grant,OKC ," SF,PF",2575,98,2676,2016-11-04,-2477
J.J. Barea,DAL ," PG,SG",588,2013,2605,2016-11-04,1425
James Ennis III,MEM ," SG,SF",712,1866,2579,2016-11-04,1154
Amir Johnson,BOS ," PF,C",1912,535,2448,2016-11-04,-1377
Trevor Booker,BKN , PF,1355,1070,2436,2016-11-04,-285
DeMarre Carroll,TOR ," SF,PF",2211,146,2368,2016-11-04,-2065
Ty Lawson,SAC , PG,1309,1029,2349,2016-11-04,-280
Marcus Morris,DET ," SF,PF",90,2232,2335,2016-11-04,2142
Tony Parker,SA , PG,2187,85,2279,2016-11-04,-2102
Jeremy Lin,BKN ," PG,SG",2000,57,2082,2016-11-04,-1943
Wilson Chandler,DEN ," SG,SF,PF",310,1757,2075,2016-11-04,1447
Tristan Thompson,CLE ," PF,C",151,1830,2011,2016-11-04,1679
Brandon Ingram,LAL ," SG,SF",1755,217,1983,2016-11-04,-1538
Ricky Rubio,MIN , PG,1495,449,1966,2016-11-04,-1046
Matthew Dellavedova,MIL ," PG,SG",1282,659,1954,2016-11-04,-623
Marcus Smart,BOS , PG,475,1421,1900,2016-11-04,946
JaMychal Green,MEM , PF,1101,770,1875,2016-11-04,-331
Michael Kidd-Gilchrist,CHA , SF,962,888,1862,2016-11-04,-74
Joe Johnson,UTA ," SG,SF",816,1026,1859,2016-11-04,210
Alex Len,PHO ," PF,C",629,1219,1855,2016-11-04,590
Dion Waiters,MIA ," SG,SF",1180,670,1852,2016-11-04,-510
Jonathon Simmons,SA ," SG,SF",1679,129,1808,2016-11-04,-1550
Josh Richardson,MIA ," SG,SF",653,1150,1806,2016-11-04,497
Tim Hardaway Jr.,ATL ," SG,SF",244,1508,1753,2016-11-04,1264
Mirza Teletovic,MIL ," SF,PF",1690,60,1752,2016-11-04,-1630
Cody Zeller,CHA ," PF,C",778,962,1747,2016-11-04,184
Jon Leuer,DET ," PF,C",134,1559,1693,2016-11-04,1425
Enes Kanter,OKC , C,1521,118,1664,2016-11-04,-1403
Tony Snell,MIL ," SG,SF",350,1303,1653,2016-11-04,953
Sergio Rodriguez,PHI , PG,344,1263,1622,2016-11-04,919
Mike Muscala,ATL ," PF,C",943,664,1611,2016-11-04,-279
Andrew Bogut,DAL , C,1400,199,1609,2016-11-04,-1201
Roy Hibbert,CHA , C,1454,141,1598,2016-11-04,-1313
Thabo Sefolosha,ATL ," SG,SF",784,728,1514,2016-11-04,-56
Robert Covington,PHI ," SF,PF",1281,207,1499,2016-11-04,-1074
Zaza Pachulia,GS , C,515,937,1453,2016-11-04,422
Allen Crabbe,POR ," PG,SG",1050,375,1429,2016-11-04,-675
Lou Williams,LAL ," PG,SG",167,6657,6829,2016-11-05,6490
Tyson Chandler,PHO , C,167,6087,6258,2016-11-05,5920
Terrence Jones,NO ," SF,PF",304,5936,6242,2016-11-05,5632
J.J. Barea,DAL ," PG,SG",246,4624,4877,2016-11-05,4378
Larry Nance Jr.,LAL , PF,167,4313,4481,2016-11-05,4146
Will Barton,DEN ," SG,SF",3385,431,3823,2016-11-05,-2954
Tyler Johnson,MIA ," PG,SG",332,3182,3521,2016-11-05,2850
C.J. Miles,IND ," SG,SF",669,2657,3327,2016-11-05,1988
Jaylen Brown,BOS , SF,446,2813,3263,2016-11-05,2367
Rondae Hollis-Jefferson,BKN ," SG,SF",588,2597,3190,2016-11-05,2009
Sean Kilpatrick,BKN ," PG,SG",737,2306,3051,2016-11-05,1569
Patty Mills,SA , PG,1008,2026,3046,2016-11-05,1018
DeMarre Carroll,TOR ," SF,PF",2771,117,2905,2016-11-05,-2654
Trevor Booker,BKN , PF,478,2324,2811,2016-11-05,1846
James Ennis III,MEM ," SG,SF",1335,1378,2715,2016-11-05,43
Ty Lawson,SAC , PG,1719,872,2602,2016-11-05,-847
Dirk Nowitzki,DAL ," PF,C",2463,90,2576,2016-11-05,-2373
Joe Johnson,UTA ," SG,SF",913,1478,2401,2016-11-05,565
Wilson Chandler,DEN ," SG,SF,PF",204,2114,2322,2016-11-05,1910
Malcolm Brogdon,MIL ," PG,SG",555,1766,2321,2016-11-05,1211
Terrence Ross,TOR ," SG,SF",79,2094,2174,2016-11-05,2015
Mike Muscala,ATL ," PF,C",1417,736,2156,2016-11-05,-681
Jonathon Simmons,SA ," SG,SF",2065,38,2110,2016-11-05,-2027
Courtney Lee,NY ," SG,SF",214,1868,2090,2016-11-05,1654
Matt Barnes,SAC ," SG,SF",1807,258,2071,2016-11-05,-1549
Dion Waiters,MIA ," SG,SF",1943,58,2006,2016-11-05,-1885
Andrew Bogut,DAL , C,1634,268,1917,2016-11-05,-1366
Lance Stephenson,NO ," SG,SF",1587,323,1912,2016-11-05,-1264
Tyler Zeller,BOS ," PF,C",84,1817,1901,2016-11-05,1733
Michael Kidd-Gilchrist,CHA , SF,671,1172,1859,2016-11-05,501
Nick Young,LAL ," SG,SF",246,1512,1762,2016-11-05,1266
Marvin Williams,CHA ," SF,PF",1622,118,1754,2016-11-05,-1504
Tony Parker,SA , PG,1669,52,1734,2016-11-05,-1617
Robert Covington,PHI ," SF,PF",1494,216,1727,2016-11-05,-1278
Cody Zeller,CHA ," PF,C",605,1099,1709,2016-11-05,494
Joakim Noah,NY ," PF,C",295,1341,1649,2016-11-05,1046
Dario Saric,PHI ," SF,PF",1274,366,1648,2016-11-05,-908
Thabo Sefolosha,ATL ," SG,SF",1220,398,1623,2016-11-05,-822
Ersan Ilyasova,PHI ," SF,PF",273,1315,1589,2016-11-05,1042
Allen Crabbe,POR ," PG,SG",1108,473,1586,2016-11-05,-635
Jamal Crawford,LAC ," SG,SF",1350,229,1586,2016-11-05,-1121
K. Korver,CLE ," SG,SF",1420,135,1586,2016-11-05,-1285
Amir Johnson,BOS ," PF,C",662,888,1552,2016-11-05,226
Sergio Rodriguez,PHI , PG,547,985,1546,2016-11-05,438
Gary Harris,DEN ," SG,SF",427,1098,1533,2016-11-05,671
Danny Green,SA ," SG,SF",494,1022,1524,2016-11-05,528
Tim Hardaway Jr.,ATL ," SG,SF",1012,502,1518,2016-11-05,-510
Ricky Rubio,MIN , PG,1239,265,1518,2016-11-05,-974
Marcus Smart,BOS , PG,336,1175,1517,2016-11-05,839
Kent Bazemore,ATL ," SG,SF",1033,400,1446,2016-11-05,-633
C.J. Miles,IND ," SG,SF",385,9392,9779,2016-11-06,9007
Wilson Chandler,DEN ," SG,SF,PF",432,4913,5346,2016-11-06,4481
Ty Lawson,SAC , PG,4199,209,4420,2016-11-06,-3990
J.J. Barea,DAL ," PG,SG",442,3823,4274,2016-11-06,3381
Tyler Johnson,MIA ," PG,SG",227,4023,4258,2016-11-06,3796
Lou Williams,LAL ," PG,SG",376,3652,4032,2016-11-06,3276
Jaylen Brown,BOS , SF,2863,941,3805,2016-11-06,-1922
Terrence Jones,NO ," SF,PF",311,3366,3681,2016-11-06,3055
Ersan Ilyasova,PHI ," SF,PF",164,3463,3629,2016-11-06,3299
Lance Stephenson,NO ," SG,SF",3496,35,3533,2016-11-06,-3461
Will Barton,DEN ," SG,SF",2853,544,3404,2016-11-06,-2309
Tyson Chandler,PHO , C,279,3106,3393,2016-11-06,2827
Larry Nance Jr.,LAL , PF,1108,2034,3142,2016-11-06,926
Joe Johnson,UTA ," SG,SF",2129,796,2943,2016-11-06,-1333
Jon Leuer,DET ," PF,C",193,2733,2929,2016-11-06,2540
Trevor Booker,BKN , PF,498,2348,2856,2016-11-06,1850
James Ennis III,MEM ," SG,SF",2384,466,2853,2016-11-06,-1918
Rondae Hollis-Jefferson,BKN ," SG,SF",636,2157,2799,2016-11-06,1521
Matt Barnes,SAC ," SG,SF",2304,204,2517,2016-11-06,-2100
Sean Kilpatrick,BKN ," PG,SG",499,1946,2453,2016-11-06,1447
Nick Young,LAL ," SG,SF",318,2031,2351,2016-11-06,1713
Michael Kidd-Gilchrist,CHA , SF,510,1784,2307,2016-11-06,1274
Patty Mills,SA , PG,1655,558,2219,2016-11-06,-1097
Cody Zeller,CHA ," PF,C",449,1586,2044,2016-11-06,1137
DeMarre Carroll,TOR ," SF,PF",1870,142,2032,2016-11-06,-1728
Matthew Dellavedova,MIL ," PG,SG",1430,487,1931,2016-11-06,-943
Mike Muscala,ATL ," PF,C",1526,312,1840,2016-11-06,-1214
Allen Crabbe,POR ," PG,SG",1477,332,1823,2016-11-06,-1145
Malcolm Brogdon,MIL ," PG,SG",1570,249,1821,2016-11-06,-1321
Sergio Rodriguez,PHI , PG,378,1424,1819,2016-11-06,1046
Emmanuel Mudiay,DEN , PG,1049,729,1801,2016-11-06,-320
Dario Saric,PHI ," SF,PF",1600,162,1768,2016-11-06,-1438
Tyler Zeller,BOS ," PF,C",481,1266,1748,2016-11-06,785
Marvin Williams,CHA ," SF,PF",1569,132,1715,2016-11-06,-1437
Joakim Noah,NY ," PF,C",779,904,1694,2016-11-06,125
Jonathon Simmons,SA ," SG,SF",1570,58,1633,2016-11-06,-1512
Kenneth Faried,DEN ," PF,C",1319,261,1600,2016-11-06,-1058
Kris Dunn,MIN , PG,1419,157,1596,2016-11-06,-1262
E'Twaun Moore,NO ," PG,SG",390,1205,1595,2016-11-06,815
Robert Covington,PHI ," SF,PF",1233,347,1589,2016-11-06,-886
Evan Turner,POR ," SG,SF",1224,323,1555,2016-11-06,-901
Danny Green,SA ," SG,SF",493,1035,1540,2016-11-06,542
Thabo Sefolosha,ATL ," SG,SF",877,653,1534,2016-11-06,-224
JaMychal Green,MEM , PF,1329,162,1496,2016-11-06,-1167
Amir Johnson,BOS ," PF,C",933,552,1486,2016-11-06,-381
Al-Farouq Aminu,POR ," SF,PF",689,772,1467,2016-11-06,83
Andrew Bogut,DAL , C,956,488,1458,2016-11-06,-468
Brandon Ingram,LAL ," SG,SF",884,546,1445,2016-11-06,-338
Ricky Rubio,MIN , PG,1169,268,1443,2016-11-06,-901
Brandon Knight,PHO ," PG,SG",1161,239,1426,2016-11-06,-922
Nick Young,LAL ," SG,SF",275,15379,15656,2016-11-07,15104
C.J. Miles,IND ," SG,SF",509,8821,9332,2016-11-07,8312
J.J. Barea,DAL ," PG,SG",394,6475,6876,2016-11-07,6081
Jaylen Brown,BOS , SF,6061,182,6249,2016-11-07,-5879
Jon Leuer,DET ," PF,C",387,5303,5693,2016-11-07,4916
Terrence Jones,NO ," SF,PF",1274,4094,5372,2016-11-07,2820
Maurice Harkless,POR , SF,187,4837,5024,2016-11-07,4650
Joe Johnson,UTA ," SG,SF",4239,586,4834,2016-11-07,-3653
Tyler Johnson,MIA ," PG,SG",652,4090,4751,2016-11-07,3438
Tyson Chandler,PHO , C,374,4275,4668,2016-11-07,3901
Lou Williams,LAL ," PG,SG",453,3994,4456,2016-11-07,3541
Ty Lawson,SAC , PG,3898,308,4215,2016-11-07,-3590
Will Barton,DEN ," SG,SF",3085,1054,4141,2016-11-07,-2031
Trevor Booker,BKN , PF,418,3580,4010,2016-11-07,3162
Rondae Hollis-Jefferson,BKN ," SG,SF",695,3210,3913,2016-11-07,2515
Sean Kilpatrick,BKN ," PG,SG",436,3300,3744,2016-11-07,2864
Larry Nance Jr.,LAL , PF,3257,368,3627,2016-11-07,-2889
Ersan Ilyasova,PHI ," SF,PF",603,2860,3465,2016-11-07,2257
Archie Goodwin,NO ," PG,SG",121,3320,3441,2016-11-07,3199
Matthew Dellavedova,MIL ," PG,SG",3057,269,3347,2016-11-07,-2788
Wilson Chandler,DEN ," SG,SF,PF",939,2397,3341,2016-11-07,1458
Michael Kidd-Gilchrist,CHA , SF,923,2312,3247,2016-11-07,1389
DeMarre Carroll,TOR ," SF,PF",2779,252,3045,2016-11-07,-2527
James Ennis III,MEM ," SG,SF",2570,390,2964,2016-11-07,-2180
Cody Zeller,CHA ," PF,C",658,2112,2774,2016-11-07,1454
Dario Saric,PHI ," SF,PF",2551,183,2741,2016-11-07,-2368
Matt Barnes,SAC ," SG,SF",2284,394,2685,2016-11-07,-1890
Thabo Sefolosha,ATL ," SG,SF",653,1884,2539,2016-11-07,1231
Malcolm Brogdon,MIL ," PG,SG",2319,135,2454,2016-11-07,-2184
Lance Stephenson,NO ," SG,SF",2430,15,2445,2016-11-07,-2415
Allen Crabbe,POR ," PG,SG",1996,363,2364,2016-11-07,-1633
Domantas Sabonis,OKC , PF,77,2285,2362,2016-11-07,2208
Sergio Rodriguez,PHI , PG,797,1510,2321,2016-11-07,713
Darren Collison,SAC , PG,357,1935,2299,2016-11-07,1578
Brandon Knight,PHO ," PG,SG",1967,267,2272,2016-11-07,-1700
Danny Green,SA ," SG,SF",603,1649,2259,2016-11-07,1046
Patty Mills,SA , PG,1590,600,2198,2016-11-07,-990
Deron Williams,DAL , PG,2046,127,2185,2016-11-07,-1919
Amir Johnson,BOS ," PF,C",1985,186,2174,2016-11-07,-1799
K. Korver,CLE ," SG,SF",1769,351,2135,2016-11-07,-1418
Ish Smith,DET , PG,1258,830,2105,2016-11-07,-428
Ricky Rubio,MIN , PG,1310,753,2070,2016-11-07,-557
Gary Harris,DEN ," SG,SF",406,1627,2037,2016-11-07,1221
Andrew Bogut,DAL , C,812,1184,2000,2016-11-07,372
E'Twaun Moore,NO ," PG,SG",430,1556,1989,2016-11-07,1126
Mike Muscala,ATL ," PF,C",1419,553,1975,2016-11-07,-866
JaMychal Green,MEM , PF,1763,189,1957,2016-11-07,-1574
Evan Turner,POR ," SG,SF",1631,319,1955,2016-11-07,-1312
Emmanuel Mudiay,DEN , PG,331,1589,1941,2016-11-07,1258
Brandon Ingram,LAL ," SG,SF",1232,680,1923,2016-11-07,-552
C.J. Miles,IND ," SG,SF",277,8872,9155,2016-11-08,8595
Domantas Sabonis,OKC , PF,174,5538,5713,2016-11-08,5364
Nick Young,LAL ," SG,SF",418,5251,5670,2016-11-08,4833
Jon Leuer,DET ," PF,C",429,4419,4850,2016-11-08,3990
Marquese Chriss,PHO , PF,367,4421,4792,2016-11-08,4054
Terrence Jones,NO ," SF,PF",4107,123,4238,2016-11-08,-3984
J.J. Barea,DAL ," PG,SG",171,3694,3876,2016-11-08,3523
Maurice Harkless,POR , SF,211,3431,3645,2016-11-08,3220
Will Barton,DEN ," SG,SF",2321,730,3064,2016-11-08,-1591
Joe Johnson,UTA ," SG,SF",2405,455,2870,2016-11-08,-1950
Trevor Booker,BKN , PF,249,2576,2836,2016-11-08,2327
Sean Kilpatrick,BKN ," PG,SG",522,2148,2676,2016-11-08,1626
Tyson Chandler,PHO , C,915,1638,2566,2016-11-08,723
Rondae Hollis-Jefferson,BKN ," SG,SF",472,1858,2336,2016-11-08,1386
Kris Dunn,MIN , PG,2020,251,2282,2016-11-08,-1769
Lou Williams,LAL ," PG,SG",314,1881,2212,2016-11-08,1567
Jaylen Brown,BOS , SF,2111,83,2200,2016-11-08,-2028
Ty Lawson,SAC , PG,1910,272,2190,2016-11-08,-1638
Kent Bazemore,ATL ," SG,SF",166,1996,2181,2016-11-08,1830
Ish Smith,DET , PG,1915,238,2164,2016-11-08,-1677
Tyler Johnson,MIA ," PG,SG",941,1152,2101,2016-11-08,211
Thabo Sefolosha,ATL ," SG,SF",572,1503,2081,2016-11-08,931
Dario Saric,PHI ," SF,PF",1997,70,2074,2016-11-08,-1927
Wilson Chandler,DEN ," SG,SF,PF",960,988,1954,2016-11-08,28
Cody Zeller,CHA ," PF,C",665,1234,1905,2016-11-08,569
Al-Farouq Aminu,POR ," SF,PF",1456,439,1904,2016-11-08,-1017
Michael Kidd-Gilchrist,CHA , SF,1377,385,1775,2016-11-08,-992
DeMarre Carroll,TOR ," SF,PF",1425,280,1726,2016-11-08,-1145
Danny Green,SA ," SG,SF",302,1412,1720,2016-11-08,1110
Deron Williams,DAL , PG,1559,127,1703,2016-11-08,-1432
Seth Curry,DAL ," PG,SG",288,1337,1629,2016-11-08,1049
Taj Gibson,CHI ," PF,C",94,1466,1586,2016-11-08,1372
Emmanuel Mudiay,DEN , PG,193,1328,1552,2016-11-08,1135
JaMychal Green,MEM , PF,1419,124,1545,2016-11-08,-1295
Justise Winslow,MIA ," SF,PF",1410,115,1540,2016-11-08,-1295
Sergio Rodriguez,PHI , PG,880,638,1530,2016-11-08,-242
Andrew Bogut,DAL , C,508,1011,1523,2016-11-08,503
Spencer Hawes,CHA ," PF,C",75,1421,1496,2016-11-08,1346
Ersan Ilyasova,PHI ," SF,PF",703,780,1486,2016-11-08,77
Jamal Crawford,LAC ," SG,SF",1188,284,1484,2016-11-08,-904
Tyus Jones,MIN , PG,33,1440,1473,2016-11-08,1407
James Ennis III,MEM ," SG,SF",1082,358,1450,2016-11-08,-724
Allen Crabbe,POR ," PG,SG",1095,327,1434,2016-11-08,-768
E'Twaun Moore,NO ," PG,SG",417,1013,1433,2016-11-08,596
Darren Collison,SAC , PG,151,1261,1420,2016-11-08,1110
Courtney Lee,NY ," SG,SF",282,1119,1408,2016-11-08,837
Dirk Nowitzki,DAL ," PF,C",728,634,1389,2016-11-08,-94
K. Korver,CLE ," SG,SF",1114,237,1367,2016-11-08,-877
Matt Barnes,SAC ," SG,SF",1018,336,1361,2016-11-08,-682
Patty Mills,SA , PG,747,608,1358,2016-11-08,-139
Maurice Harkless,POR , SF,363,8927,9291,2016-11-09,8564
Nick Young,LAL ," SG,SF",298,7364,7667,2016-11-09,7066
Seth Curry,DAL ," PG,SG",300,4805,5106,2016-11-09,4505
J.J. Barea,DAL ," PG,SG",837,3557,4409,2016-11-09,2720
Kris Dunn,MIN , PG,3985,95,4092,2016-11-09,-3890
Jaylen Brown,BOS , SF,3693,67,3764,2016-11-09,-3626
E'Twaun Moore,NO ," PG,SG",333,3387,3722,2016-11-09,3054
Tyus Jones,MIN , PG,96,3489,3585,2016-11-09,3393
C.J. Miles,IND ," SG,SF",292,3271,3571,2016-11-09,2979
Al-Farouq Aminu,POR ," SF,PF",3139,83,3232,2016-11-09,-3056
Joe Johnson,UTA ," SG,SF",2673,413,3095,2016-11-09,-2260
Trevor Booker,BKN , PF,422,2353,2786,2016-11-09,1931
Jon Leuer,DET ," PF,C",344,2315,2664,2016-11-09,1971
Lou Williams,LAL ," PG,SG",308,2243,2565,2016-11-09,1935
Robert Covington,PHI ," SF,PF",349,2036,2399,2016-11-09,1687
Tyson Chandler,PHO , C,1831,513,2364,2016-11-09,-1318
Sean Kilpatrick,BKN ," PG,SG",1452,797,2260,2016-11-09,-655
Ty Lawson,SAC , PG,1988,248,2239,2016-11-09,-1740
Danny Green,SA ," SG,SF",278,1890,2175,2016-11-09,1612
Sergio Rodriguez,PHI , PG,1757,363,2145,2016-11-09,-1394
Domantas Sabonis,OKC , PF,513,1583,2098,2016-11-09,1070
Will Barton,DEN ," SG,SF",1375,678,2061,2016-11-09,-697
Tyler Johnson,MIA ," PG,SG",457,1531,2002,2016-11-09,1074
Emmanuel Mudiay,DEN , PG,168,1775,1968,2016-11-09,1607
Terrence Jones,NO ," SF,PF",1508,369,1888,2016-11-09,-1139
Allen Crabbe,POR ," PG,SG",1675,169,1852,2016-11-09,-1506
Rondae Hollis-Jefferson,BKN ," SG,SF",898,944,1845,2016-11-09,46
Thabo Sefolosha,ATL ," SG,SF",1026,704,1735,2016-11-09,-322
JaMychal Green,MEM , PF,1683,39,1729,2016-11-09,-1644
Kent Bazemore,ATL ," SG,SF",279,1423,1714,2016-11-09,1144
DeMarre Carroll,TOR ," SF,PF",1394,281,1687,2016-11-09,-1113
Tyler Johnson,MIA ," SF,PF",51,1623,1674,2016-11-09,1572
Deron Williams,DAL , PG,1455,187,1665,2016-11-09,-1268
Marquese Chriss,PHO , PF,1055,596,1651,2016-11-09,-459
Andrew Bogut,DAL , C,1090,540,1635,2016-11-09,-550
Matt Barnes,SAC ," SG,SF",857,732,1593,2016-11-09,-125
Luol Deng,LAL ," SF,PF",1364,225,1593,2016-11-09,-1139
Cody Zeller,CHA ," PF,C",480,1108,1589,2016-11-09,628
Nikola Mirotic,CHI ," SF,PF",1376,182,1574,2016-11-09,-1194
Arron Afflalo,SAC ," SG,SF",113,1431,1545,2016-11-09,1318
Ish Smith,DET , PG,1308,200,1527,2016-11-09,-1108
Wilson Chandler,DEN ," SG,SF,PF",962,559,1526,2016-11-09,-403
Alex Len,PHO ," PF,C",705,798,1508,2016-11-09,93
Bojan Bogdanovic,BKN ," SG,SF",1150,302,1462,2016-11-09,-848
Taj Gibson,CHI ," PF,C",51,1382,1455,2016-11-09,1331
Dario Saric,PHI ," SF,PF",1066,337,1412,2016-11-09,-729
Matthew Dellavedova,MIL ," PG,SG",877,479,1370,2016-11-09,-398
James Ennis III,MEM ," SG,SF",908,416,1331,2016-11-09,-492
Marvin Williams,CHA ," SF,PF",477,823,1309,2016-11-09,346
Ersan Ilyasova,PHI ," SF,PF",994,305,1304,2016-11-09,-689
Nick Young,LAL ," SG,SF",704,4236,4951,2016-11-10,3532
Robert Covington,PHI ," SF,PF",141,4659,4811,2016-11-10,4518
Tyus Jones,MIN , PG,153,3716,3869,2016-11-10,3563
C.J. Miles,IND ," SG,SF",308,3286,3606,2016-11-10,2978
Kris Dunn,MIN , PG,3354,73,3443,2016-11-10,-3281
Maurice Harkless,POR , SF,560,2836,3398,2016-11-10,2276
Lucas Nogueira,TOR ," PF,C",53,3308,3361,2016-11-10,3255
Jaylen Brown,BOS , SF,3007,26,3040,2016-11-10,-2981
Jon Leuer,DET ," PF,C",233,2762,3000,2016-11-10,2529
Danny Green,SA ," SG,SF",184,2711,2905,2016-11-10,2527
Joe Johnson,UTA ," SG,SF",2169,379,2560,2016-11-10,-1790
J.J. Barea,DAL ," PG,SG",1255,1135,2406,2016-11-10,-120
E'Twaun Moore,NO ," PG,SG",756,1591,2351,2016-11-10,835
Seth Curry,DAL ," PG,SG",421,1907,2329,2016-11-10,1486
Alex Len,PHO ," PF,C",234,2068,2309,2016-11-10,1834
Al-Farouq Aminu,POR ," SF,PF",2196,65,2275,2016-11-10,-2131
Nikola Mirotic,CHI ," SF,PF",1972,184,2174,2016-11-10,-1788
Tyson Chandler,PHO , C,1749,356,2118,2016-11-10,-1393
Tyler Johnson,MIA ," PG,SG",512,1508,2043,2016-11-10,996
Sergio Rodriguez,PHI , PG,1773,239,2040,2016-11-10,-1534
Sean Kilpatrick,BKN ," PG,SG",1609,374,2002,2016-11-10,-1235
Will Barton,DEN ," SG,SF",1085,885,1976,2016-11-10,-200
Justin Hamilton,BKN ," PF,C",145,1728,1875,2016-11-10,1583
Lou Williams,LAL ," PG,SG",377,1453,1849,2016-11-10,1076
Thabo Sefolosha,ATL ," SG,SF",373,1383,1759,2016-11-10,1010
Trevor Booker,BKN , PF,579,1120,1714,2016-11-10,541
Wilson Chandler,DEN ," SG,SF,PF",1249,451,1708,2016-11-10,-798
Josh Richardson,MIA ," SG,SF",288,1316,1612,2016-11-10,1028
Terrence Jones,NO ," SF,PF",1056,521,1587,2016-11-10,-535
Andrew Bogut,DAL , C,1377,151,1537,2016-11-10,-1226
Tyler Johnson,MIA ," SF,PF",619,861,1480,2016-11-10,242
Jamal Crawford,LAC ," SG,SF",1283,164,1455,2016-11-10,-1119
Al Jefferson,IND ," PF,C",167,1274,1447,2016-11-10,1107
Patty Mills,SA , PG,484,957,1445,2016-11-10,473
Marvin Williams,CHA ," SF,PF",187,1232,1436,2016-11-10,1045
Michael Kidd-Gilchrist,CHA , SF,593,798,1412,2016-11-10,205
Cody Zeller,CHA ," PF,C",478,920,1405,2016-11-10,442
Allen Crabbe,POR ," PG,SG",1182,194,1392,2016-11-10,-988
Rondae Hollis-Jefferson,BKN ," SG,SF",842,535,1388,2016-11-10,-307
Bojan Bogdanovic,BKN ," SG,SF",1201,172,1388,2016-11-10,-1029
Matthew Dellavedova,MIL ," PG,SG",807,555,1380,2016-11-10,-252
DeMarre Carroll,TOR ," SF,PF",1031,322,1369,2016-11-10,-709
Ish Smith,DET , PG,994,349,1364,2016-11-10,-645
Luol Deng,LAL ," SF,PF",1136,218,1360,2016-11-10,-918
Otto Porter,WAS , SF,26,1264,1311,2016-11-10,1238
Taj Gibson,CHI ," PF,C",314,951,1305,2016-11-10,637
Mirza Teletovic,MIL ," SF,PF",684,598,1286,2016-11-10,-86
Marquese Chriss,PHO , PF,1191,92,1285,2016-11-10,-1099
Brandon Knight,PHO ," PG,SG",829,414,1279,2016-11-10,-415
Marcus Smart,BOS , PG,228,1024,1268,2016-11-10,796
Nick Young,LAL ," SG,SF",472,5032,5512,2016-11-11,4560
Josh Richardson,MIA ," SG,SF",197,4286,4484,2016-11-11,4089
Jrue Holiday,NO , PG,150,4251,4409,2016-11-11,4101
Lucas Nogueira,TOR ," PF,C",205,4000,4205,2016-11-11,3795
E'Twaun Moore,NO ," PG,SG",370,2914,3286,2016-11-11,2544
Ricky Rubio,MIN , PG,280,2894,3187,2016-11-11,2614
Al-Farouq Aminu,POR ," SF,PF",2752,82,2839,2016-11-11,-2670
Joe Johnson,UTA ," SG,SF",2284,255,2548,2016-11-11,-2029
Tyus Jones,MIN , PG,480,2065,2545,2016-11-11,1585
C.J. Miles,IND ," SG,SF",345,2067,2418,2016-11-11,1722
Jon Leuer,DET ," PF,C",676,1632,2311,2016-11-11,956
Kris Dunn,MIN , PG,2223,55,2291,2016-11-11,-2168
Alex Len,PHO ," PF,C",208,2030,2241,2016-11-11,1822
Lou Williams,LAL ," PG,SG",275,1908,2193,2016-11-11,1633
Maurice Harkless,POR , SF,808,1319,2128,2016-11-11,511
Kelly Olynyk,BOS , C,122,1968,2090,2016-11-11,1846
Michael Kidd-Gilchrist,CHA , SF,1554,366,1936,2016-11-11,-1188
Sergio Rodriguez,PHI , PG,1603,239,1859,2016-11-11,-1364
Tyler Johnson,MIA ," PG,SG",451,1358,1827,2016-11-11,907
Thabo Sefolosha,ATL ," SG,SF",255,1558,1820,2016-11-11,1303
Terrence Jones,NO ," SF,PF",714,1089,1807,2016-11-11,375
Luol Deng,LAL ," SF,PF",1655,78,1738,2016-11-11,-1577
Deron Williams,DAL , PG,1513,183,1703,2016-11-11,-1330
J.J. Barea,DAL ," PG,SG",636,1040,1690,2016-11-11,404
Sean Kilpatrick,BKN ," PG,SG",1229,411,1650,2016-11-11,-818
Robert Covington,PHI ," SF,PF",268,1346,1621,2016-11-11,1078
Jaylen Brown,BOS , SF,1569,14,1583,2016-11-11,-1555
Justin Hamilton,BKN ," PF,C",147,1376,1525,2016-11-11,1229
Will Barton,DEN ," SG,SF",790,731,1525,2016-11-11,-59
Marcus Smart,BOS , PG,225,1219,1453,2016-11-11,994
Roy Hibbert,CHA , C,343,1102,1447,2016-11-11,759
Tyson Chandler,PHO , C,949,455,1419,2016-11-11,-494
Wilson Chandler,DEN ," SG,SF,PF",963,445,1413,2016-11-11,-518
Nikola Mirotic,CHI ," SF,PF",1263,133,1412,2016-11-11,-1130
Ish Smith,DET , PG,1020,332,1370,2016-11-11,-688
Matt Barnes,SAC ," SG,SF",1089,259,1350,2016-11-11,-830
Courtney Lee,NY ," SG,SF",725,614,1344,2016-11-11,-111
Trevor Booker,BKN , PF,355,970,1340,2016-11-11,615
DeMarre Carroll,TOR ," SF,PF",980,315,1301,2016-11-11,-665
Cody Zeller,CHA ," PF,C",603,665,1271,2016-11-11,62
Patty Mills,SA , PG,632,629,1264,2016-11-11,-3
Domantas Sabonis,OKC , PF,752,472,1226,2016-11-11,-280
Danny Green,SA ," SG,SF",573,642,1222,2016-11-11,69
James Ennis III,MEM ," SG,SF",291,927,1219,2016-11-11,636
Elfrid Payton,ORL , PG,860,330,1217,2016-11-11,-530
Tim Frazier,NO ," PG,SG",543,643,1211,2016-11-11,100
Seth Curry,DAL ," PG,SG",438,769,1208,2016-11-11,331
Brandon Ingram,LAL ," SG,SF",827,345,1185,2016-11-11,-482
Ty Lawson,SAC , PG,1033,151,1184,2016-11-11,-882
Rondae Hollis-Jefferson,BKN ," SG,SF",593,560,1159,2016-11-11,-33
Lucas Nogueira,TOR ," PF,C",344,9259,9603,2016-11-12,8915
Kelly Olynyk,BOS , C,187,4036,4224,2016-11-12,3849
Maurice Harkless,POR , SF,624,3541,4169,2016-11-12,2917
Nick Young,LAL ," SG,SF",186,3709,3908,2016-11-12,3523
Ricky Rubio,MIN , PG,176,3646,3833,2016-11-12,3470
Al-Farouq Aminu,POR ," SF,PF",3503,64,3577,2016-11-12,-3439
Tyus Jones,MIN , PG,2042,1456,3499,2016-11-12,-586
Allen Crabbe,POR ," PG,SG",326,2692,3020,2016-11-12,2366
Joe Johnson,UTA ," SG,SF",2525,107,2642,2016-11-12,-2418
Wilson Chandler,DEN ," SG,SF,PF",316,2163,2483,2016-11-12,1847
Kris Dunn,MIN , PG,2340,113,2468,2016-11-12,-2227
Alex Len,PHO ," PF,C",255,2135,2397,2016-11-12,1880
C.J. Miles,IND ," SG,SF",1003,1357,2379,2016-11-12,354
Terrence Jones,NO ," SF,PF",2073,253,2331,2016-11-12,-1820
Lou Williams,LAL ," PG,SG",87,2033,2141,2016-11-12,1946
Domantas Sabonis,OKC , PF,344,1745,2089,2016-11-12,1401
Roy Hibbert,CHA , C,388,1654,2046,2016-11-12,1266
Jon Leuer,DET ," PF,C",1606,384,1994,2016-11-12,-1222
Tyler Johnson,MIA ," PG,SG",1194,705,1909,2016-11-12,-489
E'Twaun Moore,NO ," PG,SG",998,902,1903,2016-11-12,-96
J.J. Barea,DAL ," PG,SG",601,1183,1797,2016-11-12,582
Cody Zeller,CHA ," PF,C",572,1215,1789,2016-11-12,643
DeMarre Carroll,TOR ," SF,PF",1602,173,1784,2016-11-12,-1429
Josh Richardson,MIA ," SG,SF",244,1453,1699,2016-11-12,1209
Rondae Hollis-Jefferson,BKN ," SG,SF",512,1163,1679,2016-11-12,651
Thabo Sefolosha,ATL ," SG,SF",679,998,1678,2016-11-12,319
Tyson Chandler,PHO , C,993,555,1557,2016-11-12,-438
Bojan Bogdanovic,BKN ," SG,SF",1392,157,1554,2016-11-12,-1235
Will Barton,DEN ," SG,SF",674,856,1536,2016-11-12,182
Sean Kilpatrick,BKN ," PG,SG",961,528,1502,2016-11-12,-433
Deron Williams,DAL , PG,1331,158,1498,2016-11-12,-1173
Iman Shumpert,CLE ," SG,SF",119,1362,1483,2016-11-12,1243
Michael Kidd-Gilchrist,CHA , SF,1241,226,1480,2016-11-12,-1015
Jaylen Brown,BOS , SF,1447,26,1478,2016-11-12,-1421
JaMychal Green,MEM , PF,1421,44,1468,2016-11-12,-1377
Elfrid Payton,ORL , PG,1242,202,1463,2016-11-12,-1040
Matthew Dellavedova,MIL ," PG,SG",1165,277,1462,2016-11-12,-888
Ty Lawson,SAC , PG,1384,59,1446,2016-11-12,-1325
Sergio Rodriguez,PHI , PG,1155,278,1445,2016-11-12,-877
Bismack Biyombo,ORL ," PF,C",765,664,1440,2016-11-12,-101
Matt Barnes,SAC ," SG,SF",1340,87,1429,2016-11-12,-1253
Patty Mills,SA , PG,1024,378,1408,2016-11-12,-646
Ish Smith,DET , PG,1224,163,1400,2016-11-12,-1061
Luol Deng,LAL ," SF,PF",1206,155,1366,2016-11-12,-1051
Courtney Lee,NY ," SG,SF",1248,91,1346,2016-11-12,-1157
Larry Nance Jr.,LAL , PF,326,958,1286,2016-11-12,632
Ersan Ilyasova,PHI ," SF,PF",470,810,1283,2016-11-12,340
Andre Roberson,OKC ," SG,SF",122,1156,1279,2016-11-12,1034
Marcus Smart,BOS , PG,402,855,1264,2016-11-12,453
James Ennis III,MEM ," SG,SF",754,467,1223,2016-11-12,-287
Lucas Nogueira,TOR ," PF,C",303,9781,10086,2016-11-13,9478
Kelly Olynyk,BOS , C,207,5582,5792,2016-11-13,5375
Rondae Hollis-Jefferson,BKN ," SG,SF",211,4512,4727,2016-11-13,4301
Jared Dudley,PHO ," SG,SF,PF",255,3631,3886,2016-11-13,3376
Nick Young,LAL ," SG,SF",1001,2266,3276,2016-11-13,1265
Trevor Booker,BKN , PF,152,2716,2880,2016-11-13,2564
Al-Farouq Aminu,POR ," SF,PF",2755,100,2862,2016-11-13,-2655
Tyus Jones,MIN , PG,2629,184,2815,2016-11-13,-2445
Cody Zeller,CHA ," PF,C",1972,814,2793,2016-11-13,-1158
Maurice Harkless,POR , SF,775,1999,2782,2016-11-13,1224
Sean Kilpatrick,BKN ," PG,SG",313,2440,2760,2016-11-13,2127
Kris Dunn,MIN , PG,2634,93,2742,2016-11-13,-2541
Wilson Chandler,DEN ," SG,SF,PF",573,1949,2527,2016-11-13,1376
Ricky Rubio,MIN , PG,178,2328,2521,2016-11-13,2150
Alex Len,PHO ," PF,C",791,1686,2487,2016-11-13,895
Allen Crabbe,POR ," PG,SG",1080,1388,2478,2016-11-13,308
Tyson Chandler,PHO , C,1896,447,2354,2016-11-13,-1449
J.J. Barea,DAL ," PG,SG",339,1975,2320,2016-11-13,1636
Terrence Jones,NO ," SF,PF",2138,88,2229,2016-11-13,-2050
Lou Williams,LAL ," PG,SG",263,1899,2177,2016-11-13,1636
Seth Curry,DAL ," PG,SG",334,1839,2176,2016-11-13,1505
C.J. Miles,IND ," SG,SF",1028,1044,2090,2016-11-13,16
Jon Leuer,DET ," PF,C",645,1322,1969,2016-11-13,677
Domantas Sabonis,OKC , PF,996,964,1961,2016-11-13,-32
Tyler Johnson,MIA ," PG,SG",1473,420,1913,2016-11-13,-1053
Matthew Dellavedova,MIL ," PG,SG",1725,156,1893,2016-11-13,-1569
Josh Richardson,MIA ," SG,SF",234,1567,1808,2016-11-13,1333
Bojan Bogdanovic,BKN ," SG,SF",1575,209,1793,2016-11-13,-1366
DeMarre Carroll,TOR ," SF,PF",1590,144,1743,2016-11-13,-1446
Joakim Noah,NY ," PF,C",284,1404,1696,2016-11-13,1120
Danny Green,SA ," SG,SF",1551,127,1689,2016-11-13,-1424
Roy Hibbert,CHA , C,1168,509,1680,2016-11-13,-659
Will Barton,DEN ," SG,SF",829,835,1671,2016-11-13,6
Andre Roberson,OKC ," SG,SF",203,1401,1604,2016-11-13,1198
Brandon Knight,PHO ," PG,SG",1269,281,1567,2016-11-13,-988
Justin Hamilton,BKN ," PF,C",463,1054,1519,2016-11-13,591
E'Twaun Moore,NO ," PG,SG",880,595,1478,2016-11-13,-285
Deron Williams,DAL , PG,1314,138,1465,2016-11-13,-1176
Joe Johnson,UTA ," SG,SF",1047,403,1460,2016-11-13,-644
Larry Nance Jr.,LAL , PF,741,690,1437,2016-11-13,-51
JaMychal Green,MEM , PF,1360,51,1417,2016-11-13,-1309
Luol Deng,LAL ," SF,PF",1236,164,1404,2016-11-13,-1072
Kenneth Faried,DEN ," PF,C",386,982,1385,2016-11-13,596
Vince Carter,MEM ," SG,SF",69,1308,1378,2016-11-13,1239
Patty Mills,SA , PG,919,438,1361,2016-11-13,-481
Michael Kidd-Gilchrist,CHA , SF,758,579,1351,2016-11-13,-179
Sergio Rodriguez,PHI , PG,912,412,1335,2016-11-13,-500
Jusuf Nurkic,DEN , C,1253,45,1323,2016-11-13,-1208
Thabo Sefolosha,ATL ," SG,SF",668,639,1311,2016-11-13,-29
Bismack Biyombo,ORL ," PF,C",779,505,1297,2016-11-13,-274
Lucas Nogueira,TOR ," PF,C",249,11035,11287,2016-11-14,10786
Maurice Harkless,POR , SF,459,6360,6827,2016-11-14,5901
Kelly Olynyk,BOS , C,1105,4265,5371,2016-11-14,3160
Jared Dudley,PHO ," SG,SF,PF",662,4238,4900,2016-11-14,3576
John Henson,MIL ," PF,C",124,4490,4614,2016-11-14,4366
Andre Roberson,OKC ," SG,SF",795,3029,3824,2016-11-14,2234
Channing Frye,CLE ," PF,C",269,3233,3505,2016-11-14,2964
Sean Kilpatrick,BKN ," PG,SG",449,2986,3442,2016-11-14,2537
Wilson Chandler,DEN ," SG,SF,PF",493,2768,3269,2016-11-14,2275
Domantas Sabonis,OKC , PF,3058,145,3204,2016-11-14,-2913
Rondae Hollis-Jefferson,BKN ," SG,SF",370,2767,3144,2016-11-14,2397
Al-Farouq Aminu,POR ," SF,PF",2635,152,2795,2016-11-14,-2483
Cody Zeller,CHA ," PF,C",2376,412,2792,2016-11-14,-1964
Nick Young,LAL ," SG,SF",1586,1191,2790,2016-11-14,-395
Tyus Jones,MIN , PG,2639,68,2711,2016-11-14,-2571
Trevor Booker,BKN , PF,198,2477,2686,2016-11-14,2279
Lou Williams,LAL ," PG,SG",282,2376,2678,2016-11-14,2094
Kris Dunn,MIN , PG,2549,74,2628,2016-11-14,-2475
Seth Curry,DAL ," PG,SG",669,1933,2606,2016-11-14,1264
J.J. Barea,DAL ," PG,SG",608,1966,2585,2016-11-14,1358
Danny Green,SA ," SG,SF",2249,164,2421,2016-11-14,-2085
Tyson Chandler,PHO , C,1846,558,2418,2016-11-14,-1288
Michael Kidd-Gilchrist,CHA , SF,442,1962,2414,2016-11-14,1520
Thabo Sefolosha,ATL ," SG,SF",535,1860,2396,2016-11-14,1325
Nemanja Bjelica,MIN , PF,94,2286,2380,2016-11-14,2192
Alex Len,PHO ," PF,C",1962,407,2379,2016-11-14,-1555
Sergio Rodriguez,PHI , PG,1787,568,2370,2016-11-14,-1219
C.J. Miles,IND ," SG,SF",798,1504,2319,2016-11-14,706
Ricky Rubio,MIN , PG,169,2116,2296,2016-11-14,1947
Allen Crabbe,POR ," PG,SG",1746,541,2288,2016-11-14,-1205
E'Twaun Moore,NO ," PG,SG",1759,487,2253,2016-11-14,-1272
Justin Hamilton,BKN ," PF,C",513,1731,2246,2016-11-14,1218
Kenneth Faried,DEN ," PF,C",249,1954,2220,2016-11-14,1705
Jon Leuer,DET ," PF,C",755,1440,2201,2016-11-14,685
Jusuf Nurkic,DEN , C,2123,41,2186,2016-11-14,-2082
Joe Johnson,UTA ," SG,SF",1759,399,2168,2016-11-14,-1360
Joakim Noah,NY ," PF,C",885,1267,2167,2016-11-14,382
Vince Carter,MEM ," SG,SF",199,1793,1992,2016-11-14,1594
Tyler Johnson,MIA ," PG,SG",1246,729,1988,2016-11-14,-517
Brandon Knight,PHO ," PG,SG",1678,228,1933,2016-11-14,-1450
Josh Richardson,MIA ," SG,SF",392,1528,1927,2016-11-14,1136
Iman Shumpert,CLE ," SG,SF",348,1557,1905,2016-11-14,1209
Will Barton,DEN ," SG,SF",1055,832,1896,2016-11-14,-223
Terrence Jones,NO ," SF,PF",1485,354,1844,2016-11-14,-1131
DeMarre Carroll,TOR ," SF,PF",1454,347,1813,2016-11-14,-1107
Bojan Bogdanovic,BKN ," SG,SF",1325,462,1793,2016-11-14,-863
Emmanuel Mudiay,DEN , PG,1490,267,1789,2016-11-14,-1223
Nikola Jokic,DEN ," PF,C",1585,125,1745,2016-11-14,-1460
Gary Harris,DEN ," SG,SF",1673,57,1739,2016-11-14,-1616
Matthew Dellavedova,MIL ," PG,SG",1512,199,1725,2016-11-14,-1313
John Henson,MIL ," PF,C",257,9247,9504,2016-11-15,8990
Lucas Nogueira,TOR ," PF,C",3667,4307,7975,2016-11-15,640
Vince Carter,MEM ," SG,SF",179,7224,7404,2016-11-15,7045
Channing Frye,CLE ," PF,C",274,4743,5017,2016-11-15,4469
Gary Harris,DEN ," SG,SF",4493,49,4545,2016-11-15,-4444
Maurice Harkless,POR , SF,766,2632,3400,2016-11-15,1866
C.J. Miles,IND ," SG,SF",224,3159,3391,2016-11-15,2935
Will Barton,DEN ," SG,SF",555,2660,3219,2016-11-15,2105
Patrick Beverley,HOU ," PG,SG",187,2869,3057,2016-11-15,2682
Jared Dudley,PHO ," SG,SF,PF",314,2521,2835,2016-11-15,2207
Danny Green,SA ," SG,SF",2714,61,2785,2016-11-15,-2653
Trey Lyles,UTA , PF,213,2542,2756,2016-11-15,2329
Sean Kilpatrick,BKN ," PG,SG",1623,1110,2746,2016-11-15,-513
Rondae Hollis-Jefferson,BKN ," SG,SF",1768,861,2635,2016-11-15,-907
Sergio Rodriguez,PHI , PG,2301,295,2609,2016-11-15,-2006
Nick Young,LAL ," SG,SF",1679,801,2496,2016-11-15,-878
Jon Leuer,DET ," PF,C",523,1833,2365,2016-11-15,1310
Seth Curry,DAL ," PG,SG",700,1613,2314,2016-11-15,913
Mike Muscala,ATL ," PF,C",422,1874,2298,2016-11-15,1452
Kelly Olynyk,BOS , C,1709,523,2235,2016-11-15,-1186
Tyreke Evans,NO ," PG,SG,SF",192,2033,2227,2016-11-15,1841
Thabo Sefolosha,ATL ," SG,SF",738,1348,2091,2016-11-15,610
Michael Kidd-Gilchrist,CHA , SF,776,1304,2088,2016-11-15,528
J.J. Barea,DAL ," PG,SG",355,1693,2066,2016-11-15,1338
Joe Johnson,UTA ," SG,SF",1894,161,2058,2016-11-15,-1733
E'Twaun Moore,NO ," PG,SG",1873,149,2028,2016-11-15,-1724
Wilson Chandler,DEN ," SG,SF,PF",362,1526,1889,2016-11-15,1164
Justin Hamilton,BKN ," PF,C",1639,203,1844,2016-11-15,-1436
Domantas Sabonis,OKC , PF,1794,34,1832,2016-11-15,-1760
DeMarre Carroll,TOR ," SF,PF",1488,309,1803,2016-11-15,-1179
Josh Richardson,MIA ," SG,SF",719,1070,1794,2016-11-15,351
Tyson Chandler,PHO , C,673,1070,1759,2016-11-15,397
Dion Waiters,MIA ," SG,SF",292,1454,1749,2016-11-15,1162
Lou Williams,LAL ," PG,SG",509,1197,1719,2016-11-15,688
Justise Winslow,MIA ," SF,PF",1480,216,1707,2016-11-15,-1264
Tyler Johnson,MIA ," PG,SG",956,735,1706,2016-11-15,-221
Al-Farouq Aminu,POR ," SF,PF",1542,159,1703,2016-11-15,-1383
Kris Dunn,MIN , PG,1588,85,1679,2016-11-15,-1503
Nemanja Bjelica,MIN , PF,815,818,1633,2016-11-15,3
Cody Zeller,CHA ," PF,C",1103,487,1592,2016-11-15,-616
Marcus Smart,BOS , PG,197,1377,1582,2016-11-15,1180
Bojan Bogdanovic,BKN ," SG,SF",756,786,1550,2016-11-15,30
Joakim Noah,NY ," PF,C",1187,345,1546,2016-11-15,-842
Tim Frazier,NO ," PG,SG",1210,302,1537,2016-11-15,-908
K. Korver,CLE ," SG,SF",820,698,1535,2016-11-15,-122
James Ennis III,MEM ," SG,SF",1452,66,1518,2016-11-15,-1386
Clint Capela,HOU ," PF,C",149,1303,1465,2016-11-15,1154
Trevor Booker,BKN , PF,644,808,1461,2016-11-15,164
Jamal Crawford,LAC ," SG,SF",291,1111,1405,2016-11-15,820
Andre Roberson,OKC ," SG,SF",1114,267,1384,2016-11-15,-847
Lucas Nogueira,TOR ," PF,C",9653,300,9956,2016-11-16,-9353
Patrick Beverley,HOU ," PG,SG",190,7323,7515,2016-11-16,7133
Channing Frye,CLE ," PF,C",777,5847,6624,2016-11-16,5070
J.J. Barea,DAL ," PG,SG",3998,1018,5031,2016-11-16,-2980
Mike Muscala,ATL ," PF,C",346,4401,4753,2016-11-16,4055
Sean Kilpatrick,BKN ," PG,SG",4183,202,4393,2016-11-16,-3981
Wilson Chandler,DEN ," SG,SF,PF",341,3654,4000,2016-11-16,3313
Terrence Jones,NO ," SF,PF",238,3585,3826,2016-11-16,3347
John Henson,MIL ," PF,C",634,3002,3637,2016-11-16,2368
Nick Young,LAL ," SG,SF",3068,469,3549,2016-11-16,-2599
Vince Carter,MEM ," SG,SF",538,2709,3247,2016-11-16,2171
Maurice Harkless,POR , SF,1184,1947,3138,2016-11-16,763
Seth Curry,DAL ," PG,SG",1040,2058,3101,2016-11-16,1018
Gary Harris,DEN ," SG,SF",3030,52,3088,2016-11-16,-2978
Trey Lyles,UTA , PF,220,2838,3061,2016-11-16,2618
Ersan Ilyasova,PHI ," SF,PF",256,2640,2900,2016-11-16,2384
Josh Richardson,MIA ," SG,SF",205,2689,2900,2016-11-16,2484
Rondae Hollis-Jefferson,BKN ," SG,SF",2540,330,2877,2016-11-16,-2210
Tim Frazier,NO ," PG,SG",2577,260,2864,2016-11-16,-2317
Jared Dudley,PHO ," SG,SF,PF",1240,1594,2834,2016-11-16,354
Will Barton,DEN ," SG,SF",865,1920,2791,2016-11-16,1055
C.J. Miles,IND ," SG,SF",609,2142,2764,2016-11-16,1533
Deron Williams,DAL , PG,991,1516,2515,2016-11-16,525
Tyson Chandler,PHO , C,600,1870,2480,2016-11-16,1270
Bojan Bogdanovic,BKN ," SG,SF",312,2052,2374,2016-11-16,1740
Thabo Sefolosha,ATL ," SG,SF",1833,444,2282,2016-11-16,-1389
Tyler Johnson,MIA ," SF,PF",195,2044,2239,2016-11-16,1849
Justise Winslow,MIA ," SF,PF",2146,75,2235,2016-11-16,-2071
Clint Capela,HOU ," PF,C",105,2019,2142,2016-11-16,1914
Jon Leuer,DET ," PF,C",373,1602,1980,2016-11-16,1229
Tyler Johnson,MIA ," PG,SG",925,1016,1958,2016-11-16,91
Dion Waiters,MIA ," SG,SF",437,1384,1823,2016-11-16,947
Allen Crabbe,POR ," PG,SG",494,1314,1809,2016-11-16,820
Alex Len,PHO ," PF,C",1504,264,1782,2016-11-16,-1240
Jusuf Nurkic,DEN , C,1508,117,1644,2016-11-16,-1391
Michael Kidd-Gilchrist,CHA , SF,1096,505,1612,2016-11-16,-591
Lou Williams,LAL ," PG,SG",1059,524,1604,2016-11-16,-535
Sergio Rodriguez,PHI , PG,924,653,1590,2016-11-16,-271
Brandon Knight,PHO ," PG,SG",672,881,1581,2016-11-16,209
Kenneth Faried,DEN ," PF,C",117,1421,1559,2016-11-16,1304
Kelly Olynyk,BOS , C,1222,332,1556,2016-11-16,-890
DeMarre Carroll,TOR ," SF,PF",1120,424,1547,2016-11-16,-696
Norman Powell,TOR ," SG,SF",475,1071,1546,2016-11-16,596
Matthew Dellavedova,MIL ," PG,SG",720,698,1426,2016-11-16,-22
Robert Covington,PHI ," SF,PF",1125,293,1425,2016-11-16,-832
Joakim Noah,NY ," PF,C",381,983,1378,2016-11-16,602
Danny Green,SA ," SG,SF",1205,163,1374,2016-11-16,-1042
Cody Zeller,CHA ," PF,C",570,792,1369,2016-11-16,222
Dario Saric,PHI ," SF,PF",317,1044,1369,2016-11-16,727
Kris Dunn,MIN , PG,1259,75,1337,2016-11-16,-1184
J.J. Barea,DAL ," PG,SG",15051,167,15235,2016-11-17,-14884
Wilson Chandler,DEN ," SG,SF,PF",157,9692,9855,2016-11-17,9535
Seth Curry,DAL ," PG,SG",654,7016,7681,2016-11-17,6362
Lucas Nogueira,TOR ," PF,C",6510,151,6671,2016-11-17,-6359
Jon Leuer,DET ," PF,C",143,6148,6295,2016-11-17,6005
Terrence Jones,NO ," SF,PF",164,4180,4350,2016-11-17,4016
Patrick Beverley,HOU ," PG,SG",350,3809,4159,2016-11-17,3459
Channing Frye,CLE ," PF,C",870,3245,4118,2016-11-17,2375
Tim Frazier,NO ," PG,SG",3321,178,3527,2016-11-17,-3143
Mike Muscala,ATL ," PF,C",518,2987,3509,2016-11-17,2469
Vince Carter,MEM ," SG,SF",616,2672,3289,2016-11-17,2056
Trey Lyles,UTA , PF,640,2363,3007,2016-11-17,1723
Ersan Ilyasova,PHI ," SF,PF",729,2262,2998,2016-11-17,1533
Sergio Rodriguez,PHI , PG,2076,767,2855,2016-11-17,-1309
Robert Covington,PHI ," SF,PF",2643,163,2817,2016-11-17,-2480
Sean Kilpatrick,BKN ," PG,SG",2413,206,2635,2016-11-17,-2207
Nick Young,LAL ," SG,SF",2193,392,2606,2016-11-17,-1801
Tony Parker,SA , PG,190,2209,2403,2016-11-17,2019
Clint Capela,HOU ," PF,C",177,2135,2326,2016-11-17,1958
Tyson Chandler,PHO , C,800,1483,2289,2016-11-17,683
Ish Smith,DET , PG,407,1814,2238,2016-11-17,1407
Alex Len,PHO ," PF,C",2039,141,2193,2016-11-17,-1898
C.J. Miles,IND ," SG,SF",888,1201,2099,2016-11-17,313
Maurice Harkless,POR , SF,713,1372,2097,2016-11-17,659
John Henson,MIL ," PF,C",1160,911,2074,2016-11-17,-249
Bojan Bogdanovic,BKN ," SG,SF",202,1855,2069,2016-11-17,1653
Thabo Sefolosha,ATL ," SG,SF",1865,145,2018,2016-11-17,-1720
Jusuf Nurkic,DEN , C,1866,115,2016,2016-11-17,-1751
Kenneth Faried,DEN ," PF,C",56,1923,2006,2016-11-17,1867
Dion Waiters,MIA ," SG,SF",465,1536,2005,2016-11-17,1071
Greg Monroe,MIL ," PF,C",1754,163,1952,2016-11-17,-1591
Tyler Johnson,MIA ," PG,SG",1266,607,1890,2016-11-17,-659
Jared Dudley,PHO ," SG,SF,PF",1538,341,1884,2016-11-17,-1197
Deron Williams,DAL , PG,1390,437,1830,2016-11-17,-953
Joakim Noah,NY ," PF,C",687,1025,1723,2016-11-17,338
Will Barton,DEN ," SG,SF",766,929,1702,2016-11-17,163
Josh Richardson,MIA ," SG,SF",479,1215,1696,2016-11-17,736
Brandon Knight,PHO ," PG,SG",197,1458,1679,2016-11-17,1261
Matthew Dellavedova,MIL ," PG,SG",1061,599,1672,2016-11-17,-462
Allen Crabbe,POR ," PG,SG",838,802,1646,2016-11-17,-36
Justise Winslow,MIA ," SF,PF",1531,84,1635,2016-11-17,-1447
Cody Zeller,CHA ," PF,C",478,1145,1629,2016-11-17,667
Rondae Hollis-Jefferson,BKN ," SG,SF",1234,384,1627,2016-11-17,-850
Derrick Favors,UTA ," PF,C",1497,104,1622,2016-11-17,-1393
Courtney Lee,NY ," SG,SF",1370,202,1581,2016-11-17,-1168
Kelly Olynyk,BOS , C,1233,329,1571,2016-11-17,-904
Gary Harris,DEN ," SG,SF",1482,67,1559,2016-11-17,-1415
Marcus Morris,DET ," SF,PF",1360,167,1551,2016-11-17,-1193
Tyler Johnson,MIA ," SF,PF",549,997,1548,2016-11-17,448
Jameer Nelson,DEN , PG,94,1440,1534,2016-11-17,1346
J.J. Barea,DAL ," PG,SG",11153,91,11258,2016-11-18,-11062
Wilson Chandler,DEN ," SG,SF,PF",224,5523,5756,2016-11-18,5299
C.J. Miles,IND ," SG,SF",4306,724,5049,2016-11-18,-3582
Seth Curry,DAL ," PG,SG",567,4471,5048,2016-11-18,3904
Jon Leuer,DET ," PF,C",205,4714,4925,2016-11-18,4509
Channing Frye,CLE ," PF,C",2113,1829,3944,2016-11-18,-284
Cody Zeller,CHA ," PF,C",224,3572,3803,2016-11-18,3348
Vince Carter,MEM ," SG,SF",582,2949,3533,2016-11-18,2367
Lucas Nogueira,TOR ," PF,C",3162,187,3360,2016-11-18,-2975
Terrence Jones,NO ," SF,PF",146,2827,2974,2016-11-18,2681
Patrick Beverley,HOU ," PG,SG",567,2222,2797,2016-11-18,1655
Dion Waiters,MIA ," SG,SF",269,2499,2771,2016-11-18,2230
Sean Kilpatrick,BKN ," PG,SG",2351,264,2631,2016-11-18,-2087
Sergio Rodriguez,PHI , PG,2286,302,2607,2016-11-18,-1984
Nik Stauskas,PHI ," SG,SF",157,2421,2579,2016-11-18,2264
Maurice Harkless,POR , SF,753,1665,2430,2016-11-18,912
Tyson Chandler,PHO , C,1627,732,2368,2016-11-18,-895
Ish Smith,DET , PG,465,1619,2094,2016-11-18,1154
Robert Covington,PHI ," SF,PF",1931,96,2037,2016-11-18,-1835
Mike Muscala,ATL ," PF,C",474,1551,2029,2016-11-18,1077
Nick Young,LAL ," SG,SF",1383,515,1925,2016-11-18,-868
Josh Richardson,MIA ," SG,SF",317,1435,1759,2016-11-18,1118
Tyler Johnson,MIA ," SF,PF",286,1442,1729,2016-11-18,1156
Greg Monroe,MIL ," PF,C",1574,112,1714,2016-11-18,-1462
Tyler Johnson,MIA ," PG,SG",1199,504,1712,2016-11-18,-695
Clint Capela,HOU ," PF,C",154,1547,1712,2016-11-18,1393
Tony Parker,SA , PG,311,1391,1703,2016-11-18,1080
Ersan Ilyasova,PHI ," SF,PF",814,863,1680,2016-11-18,49
Tim Frazier,NO ," PG,SG",1277,351,1660,2016-11-18,-926
Allen Crabbe,POR ," PG,SG",1469,142,1618,2016-11-18,-1327
John Henson,MIL ," PF,C",428,1184,1613,2016-11-18,756
Jrue Holiday,NO , PG,37,1522,1582,2016-11-18,1485
Thabo Sefolosha,ATL ," SG,SF",1443,123,1574,2016-11-18,-1320
Bojan Bogdanovic,BKN ," SG,SF",291,1257,1561,2016-11-18,966
Kelly Olynyk,BOS , C,1198,334,1535,2016-11-18,-864
Will Barton,DEN ," SG,SF",379,1115,1503,2016-11-18,736
Brandon Knight,PHO ," PG,SG",147,1312,1483,2016-11-18,1165
Jared Dudley,PHO ," SG,SF,PF",332,1126,1459,2016-11-18,794
Trevor Booker,BKN , PF,651,767,1439,2016-11-18,116
Alex Len,PHO ," PF,C",561,810,1381,2016-11-18,249
Trey Lyles,UTA , PF,751,624,1379,2016-11-18,-127
Matthew Dellavedova,MIL ," PG,SG",1013,342,1368,2016-11-18,-671
Rondae Hollis-Jefferson,BKN ," SG,SF",739,593,1339,2016-11-18,-146
Deron Williams,DAL , PG,1015,290,1310,2016-11-18,-725
Jamal Crawford,LAC ," SG,SF",256,1007,1271,2016-11-18,751
Courtney Lee,NY ," SG,SF",1216,48,1269,2016-11-18,-1168
Michael Kidd-Gilchrist,CHA , SF,663,558,1249,2016-11-18,-105
Marcus Morris,DET ," SF,PF",1013,213,1247,2016-11-18,-800
Danny Green,SA ," SG,SF",337,879,1229,2016-11-18,542
Dario Saric,PHI ," SF,PF",369,834,1213,2016-11-18,465
Wilson Chandler,DEN ," SG,SF,PF",89,8076,8176,2016-11-19,7987
Matt Barnes,SAC ," SG,SF",214,6421,6635,2016-11-19,6207
C.J. Miles,IND ," SG,SF",6432,132,6580,2016-11-19,-6300
Cody Zeller,CHA ," PF,C",1255,3847,5111,2016-11-19,2592
Terrence Ross,TOR ," SG,SF",175,4706,4883,2016-11-19,4531
J.J. Barea,DAL ," PG,SG",4280,116,4412,2016-11-19,-4164
Terrence Jones,NO ," SF,PF",796,2782,3584,2016-11-19,1986
Jonathan Gibson,DAL ," PG,SG",49,3460,3509,2016-11-19,3411
Ty Lawson,SAC , PG,194,3302,3498,2016-11-19,3108
Mike Muscala,ATL ," PF,C",422,2828,3250,2016-11-19,2406
Jon Leuer,DET ," PF,C",1598,1603,3207,2016-11-19,5
Channing Frye,CLE ," PF,C",2715,367,3089,2016-11-19,-2348
Lucas Nogueira,TOR ," PF,C",2667,353,3036,2016-11-19,-2314
Sean Kilpatrick,BKN ," PG,SG",2584,375,2972,2016-11-19,-2209
Vince Carter,MEM ," SG,SF",2416,454,2872,2016-11-19,-1962
Nick Young,LAL ," SG,SF",325,2515,2858,2016-11-19,2190
Tyler Johnson,MIA ," PG,SG",2389,326,2735,2016-11-19,-2063
Jared Dudley,PHO ," SG,SF,PF",832,1842,2674,2016-11-19,1010
Kelly Olynyk,BOS , C,2545,68,2621,2016-11-19,-2477
Alan Williams,PHO , PF,197,2376,2573,2016-11-19,2179
Seth Curry,DAL ," PG,SG",1696,817,2516,2016-11-19,-879
Maurice Harkless,POR , SF,743,1566,2323,2016-11-19,823
Jrue Holiday,NO , PG,32,2249,2300,2016-11-19,2217
Tyson Chandler,PHO , C,1882,204,2098,2016-11-19,-1678
Greg Monroe,MIL ," PF,C",1740,201,1977,2016-11-19,-1539
Tony Parker,SA , PG,326,1602,1930,2016-11-19,1276
Will Barton,DEN ," SG,SF",302,1440,1747,2016-11-19,1138
Patrick Beverley,HOU ," PG,SG",766,929,1702,2016-11-19,163
E'Twaun Moore,NO ," PG,SG",1385,276,1663,2016-11-19,-1109
Robert Covington,PHI ," SF,PF",1552,86,1651,2016-11-19,-1466
Tyreke Evans,NO ," PG,SG,SF",115,1466,1586,2016-11-19,1351
Sergio Rodriguez,PHI , PG,1244,298,1562,2016-11-19,-946
Tim Frazier,NO ," PG,SG",626,906,1561,2016-11-19,280
Dion Waiters,MIA ," SG,SF",514,1039,1555,2016-11-19,525
Bojan Bogdanovic,BKN ," SG,SF",377,1158,1548,2016-11-19,781
T.J. Warren,PHO , SF,1414,65,1519,2016-11-19,-1349
Trey Lyles,UTA , PF,298,1211,1517,2016-11-19,913
Rondae Hollis-Jefferson,BKN ," SG,SF",674,825,1507,2016-11-19,151
Andre Roberson,OKC ," SG,SF",275,1211,1488,2016-11-19,936
Thabo Sefolosha,ATL ," SG,SF",1348,129,1483,2016-11-19,-1219
John Henson,MIL ," PF,C",1049,404,1464,2016-11-19,-645
Marcus Morris,DET ," SF,PF",1174,254,1457,2016-11-19,-920
Alex Len,PHO ," PF,C",564,835,1408,2016-11-19,271
Trevor Booker,BKN , PF,994,388,1400,2016-11-19,-606
Ish Smith,DET , PG,941,445,1399,2016-11-19,-496
Lou Williams,LAL ," PG,SG",161,1195,1386,2016-11-19,1034
Nik Stauskas,PHI ," SG,SF",338,1046,1386,2016-11-19,708
Deron Williams,DAL , PG,1117,225,1353,2016-11-19,-892
Michael Kidd-Gilchrist,CHA , SF,922,373,1312,2016-11-19,-549
DeMarre Carroll,TOR ," SF,PF",962,340,1310,2016-11-19,-622
Jonathan Gibson,DAL ," PG,SG",147,11459,11606,2016-11-20,11312
Will Barton,DEN ," SG,SF",278,5103,5387,2016-11-20,4825
Sean Kilpatrick,BKN ," PG,SG",4825,263,5104,2016-11-20,-4562
Alan Williams,PHO , PF,188,4538,4726,2016-11-20,4350
C.J. Miles,IND ," SG,SF",3837,156,4017,2016-11-20,-3681
Matt Barnes,SAC ," SG,SF",1104,2808,3913,2016-11-20,1704
Wilson Chandler,DEN ," SG,SF,PF",236,3462,3711,2016-11-20,3226
Tyler Johnson,MIA ," PG,SG",3484,110,3611,2016-11-20,-3374
Dion Waiters,MIA ," SG,SF",255,3078,3336,2016-11-20,2823
Terrence Ross,TOR ," SG,SF",828,2430,3261,2016-11-20,1602
Mike Muscala,ATL ," PF,C",1939,1209,3152,2016-11-20,-730
J.J. Barea,DAL ," PG,SG",2558,276,2842,2016-11-20,-2282
Lucas Nogueira,TOR ," PF,C",2304,308,2616,2016-11-20,-1996
Nick Young,LAL ," SG,SF",532,2051,2602,2016-11-20,1519
Nik Stauskas,PHI ," SG,SF",152,2316,2469,2016-11-20,2164
Greg Monroe,MIL ," PF,C",2075,347,2458,2016-11-20,-1728
Jon Leuer,DET ," PF,C",1894,464,2365,2016-11-20,-1430
Chandler Parsons,MEM ," SF,PF",2089,174,2291,2016-11-20,-1915
Trey Lyles,UTA , PF,745,1481,2232,2016-11-20,736
Vince Carter,MEM ," SG,SF",1983,217,2202,2016-11-20,-1766
Maurice Harkless,POR , SF,1152,1006,2168,2016-11-20,-146
Tyler Johnson,MIA ," SF,PF",245,1900,2146,2016-11-20,1655
Kelly Olynyk,BOS , C,2096,37,2135,2016-11-20,-2059
Tony Parker,SA , PG,227,1791,2021,2016-11-20,1564
E'Twaun Moore,NO ," PG,SG",1869,39,1913,2016-11-20,-1830
Seth Curry,DAL ," PG,SG",1210,662,1882,2016-11-20,-548
Ty Lawson,SAC , PG,741,1122,1864,2016-11-20,381
Cody Zeller,CHA ," PF,C",1307,506,1816,2016-11-20,-801
Tim Frazier,NO ," PG,SG",305,1477,1806,2016-11-20,1172
John Henson,MIL ," PF,C",1565,182,1752,2016-11-20,-1383
Jared Dudley,PHO ," SG,SF,PF",1082,656,1740,2016-11-20,-426
Terrence Jones,NO ," SF,PF",1091,636,1732,2016-11-20,-455
Robert Covington,PHI ," SF,PF",1544,156,1711,2016-11-20,-1388
Buddy Hield,NO , SG,1683,8,1695,2016-11-20,-1675
Channing Frye,CLE ," PF,C",1344,340,1689,2016-11-20,-1004
Josh Richardson,MIA ," SG,SF",220,1390,1617,2016-11-20,1170
Rondae Hollis-Jefferson,BKN ," SG,SF",1032,560,1607,2016-11-20,-472
Patrick Beverley,HOU ," PG,SG",735,803,1551,2016-11-20,68
Jrue Holiday,NO , PG,53,1431,1505,2016-11-20,1378
Alex Len,PHO ," PF,C",565,886,1464,2016-11-20,321
Bismack Biyombo,ORL ," PF,C",247,1203,1455,2016-11-20,956
Tyson Chandler,PHO , C,1144,274,1427,2016-11-20,-870
Joakim Noah,NY ," PF,C",1065,301,1380,2016-11-20,-764
Clint Capela,HOU ," PF,C",113,1240,1371,2016-11-20,1127
DeMarre Carroll,TOR ," SF,PF",532,829,1368,2016-11-20,297
Frank Kaminsky,CHA ," PF,C",206,1136,1347,2016-11-20,930
Dario Saric,PHI ," SF,PF",315,993,1322,2016-11-20,678
Andre Roberson,OKC ," SG,SF",576,731,1311,2016-11-20,155
Sergio Rodriguez,PHI , PG,565,722,1302,2016-11-20,157
Bojan Bogdanovic,BKN ," SG,SF",492,761,1266,2016-11-20,269
Jonathan Gibson,DAL ," PG,SG",2116,8573,10689,2016-11-21,6457
Will Barton,DEN ," SG,SF",364,7735,8105,2016-11-21,7371
Sean Kilpatrick,BKN ," PG,SG",6005,114,6127,2016-11-21,-5891
Larry Nance Jr.,LAL , PF,197,5619,5818,2016-11-21,5422
Langston Galloway,NO ," PG,SG",143,5032,5176,2016-11-21,4889
Alan Williams,PHO , PF,831,4345,5176,2016-11-21,3514
C.J. Miles,IND ," SG,SF",4383,486,4882,2016-11-21,-3897
Dion Waiters,MIA ," SG,SF",402,3755,4158,2016-11-21,3353
Lucas Nogueira,TOR ," PF,C",3901,113,4015,2016-11-21,-3788
Nick Young,LAL ," SG,SF",489,3320,3823,2016-11-21,2831
Tyler Johnson,MIA ," PG,SG",3483,193,3687,2016-11-21,-3290
Chandler Parsons,MEM ," SF,PF",3427,133,3575,2016-11-21,-3294
J.J. Barea,DAL ," PG,SG",3148,371,3523,2016-11-21,-2777
Wilson Chandler,DEN ," SG,SF,PF",446,2709,3163,2016-11-21,2263
Tony Parker,SA , PG,838,2210,3052,2016-11-21,1372
Nik Stauskas,PHI ," SG,SF",594,2431,3026,2016-11-21,1837
Tim Frazier,NO ," PG,SG",255,2639,2910,2016-11-21,2384
Greg Monroe,MIL ," PF,C",2453,377,2861,2016-11-21,-2076
Maurice Harkless,POR , SF,1606,1230,2844,2016-11-21,-376
Terrence Ross,TOR ," SG,SF",2367,458,2826,2016-11-21,-1909
Mike Muscala,ATL ," PF,C",2132,687,2822,2016-11-21,-1445
Matt Barnes,SAC ," SG,SF",1817,980,2801,2016-11-21,-837
Seth Curry,DAL ," PG,SG",1138,1576,2721,2016-11-21,438
Tyson Chandler,PHO , C,2190,500,2698,2016-11-21,-1690
Tyler Johnson,MIA ," SF,PF",778,1859,2638,2016-11-21,1081
Frank Kaminsky,CHA ," PF,C",288,2216,2506,2016-11-21,1928
Cody Zeller,CHA ," PF,C",1837,607,2452,2016-11-21,-1230
Terrence Jones,NO ," SF,PF",612,1803,2421,2016-11-21,1191
DeMarre Carroll,TOR ," SF,PF",595,1756,2361,2016-11-21,1161
Channing Frye,CLE ," PF,C",1786,496,2286,2016-11-21,-1290
John Henson,MIL ," PF,C",2111,161,2281,2016-11-21,-1950
Bismack Biyombo,ORL ," PF,C",285,1985,2277,2016-11-21,1700
Alex Len,PHO ," PF,C",345,1834,2186,2016-11-21,1489
Patrick Beverley,HOU ," PG,SG",1064,1077,2148,2016-11-21,13
Jon Leuer,DET ," PF,C",1515,622,2142,2016-11-21,-893
Andre Roberson,OKC ," SG,SF",616,1522,2138,2016-11-21,906
Vince Carter,MEM ," SG,SF",1763,335,2101,2016-11-21,-1428
Josh Richardson,MIA ," SG,SF",770,1317,2095,2016-11-21,547
Lou Williams,LAL ," PG,SG",160,1894,2073,2016-11-21,1734
Thabo Sefolosha,ATL ," SG,SF",965,1052,2019,2016-11-21,87
James Ennis III,MEM ," SG,SF",636,1368,2004,2016-11-21,732
Trey Lyles,UTA , PF,1624,370,1996,2016-11-21,-1254
Deron Williams,DAL , PG,1738,227,1975,2016-11-21,-1511
Kelly Olynyk,BOS , C,1883,37,1926,2016-11-21,-1846
Dario Saric,PHI ," SF,PF",802,1112,1924,2016-11-21,310
Andrew Bogut,DAL , C,1592,320,1916,2016-11-21,-1272
Sergio Rodriguez,PHI , PG,827,1013,1858,2016-11-21,186
Jared Dudley,PHO ," SG,SF,PF",1257,586,1848,2016-11-21,-671
T.J. Warren,PHO , SF,1612,187,1836,2016-11-21,-1425
Marvin Williams,CHA ," SF,PF",1447,304,1767,2016-11-21,-1143
Marco Belinelli,CHA ," SG,SF",131,7560,7692,2016-11-22,7429
Jonathan Gibson,DAL ," PG,SG",4094,201,4295,2016-11-22,-3893
Jamal Murray,DEN , SG,174,3756,3932,2016-11-22,3582
Seth Curry,DAL ," PG,SG",230,3419,3657,2016-11-22,3189
Dion Waiters,MIA ," SG,SF",414,2669,3091,2016-11-22,2255
Spencer Hawes,CHA ," PF,C",77,2951,3028,2016-11-22,2874
Larry Nance Jr.,LAL , PF,550,2302,2853,2016-11-22,1752
Will Barton,DEN ," SG,SF",599,2195,2800,2016-11-22,1596
Langston Galloway,NO ," PG,SG",861,1919,2782,2016-11-22,1058
Alex Len,PHO ," PF,C",197,2434,2639,2016-11-22,2237
Tim Frazier,NO ," PG,SG",148,2282,2447,2016-11-22,2134
Greg Monroe,MIL ," PF,C",1821,498,2343,2016-11-22,-1323
Sean Kilpatrick,BKN ," PG,SG",2164,105,2275,2016-11-22,-2059
C.J. Miles,IND ," SG,SF",1397,728,2131,2016-11-22,-669
Tyler Johnson,MIA ," PG,SG",1946,155,2112,2016-11-22,-1791
Terrence Jones,NO ," SF,PF",506,1564,2077,2016-11-22,1058
Nick Young,LAL ," SG,SF",227,1722,1962,2016-11-22,1495
Lucas Nogueira,TOR ," PF,C",1896,42,1945,2016-11-22,-1854
James Ennis III,MEM ," SG,SF",1876,65,1943,2016-11-22,-1811
Bismack Biyombo,ORL ," PF,C",186,1675,1866,2016-11-22,1489
Mike Muscala,ATL ," PF,C",1380,365,1751,2016-11-22,-1015
Frank Kaminsky,CHA ," PF,C",355,1358,1715,2016-11-22,1003
Tyson Chandler,PHO , C,1418,281,1703,2016-11-22,-1137
Marvin Williams,CHA ," SF,PF",1475,160,1645,2016-11-22,-1315
John Henson,MIL ," PF,C",1516,57,1580,2016-11-22,-1459
Alan Williams,PHO , PF,1103,466,1569,2016-11-22,-637
Wilson Chandler,DEN ," SG,SF,PF",166,1323,1500,2016-11-22,1157
Patrick Beverley,HOU ," PG,SG",1126,306,1440,2016-11-22,-820
Maurice Harkless,POR , SF,570,857,1436,2016-11-22,287
Cody Zeller,CHA ," PF,C",1063,346,1415,2016-11-22,-717
Jon Leuer,DET ," PF,C",532,868,1405,2016-11-22,336
Channing Frye,CLE ," PF,C",838,536,1382,2016-11-22,-302
J.J. Barea,DAL ," PG,SG",1159,222,1382,2016-11-22,-937
Andre Roberson,OKC ," SG,SF",433,947,1381,2016-11-22,514
Terrence Ross,TOR ," SG,SF",1193,183,1379,2016-11-22,-1010
Jusuf Nurkic,DEN , C,202,1106,1322,2016-11-22,904
Jared Dudley,PHO ," SG,SF,PF",1161,146,1308,2016-11-22,-1015
Thabo Sefolosha,ATL ," SG,SF",676,628,1307,2016-11-22,-48
Tony Parker,SA , PG,724,552,1280,2016-11-22,-172
Ish Smith,DET , PG,317,950,1278,2016-11-22,633
Evan Turner,POR ," SG,SF",422,849,1274,2016-11-22,427
Chandler Parsons,MEM ," SF,PF",1138,112,1267,2016-11-22,-1026
K. Korver,CLE ," SG,SF",231,995,1233,2016-11-22,764
Courtney Lee,NY ," SG,SF",714,506,1220,2016-11-22,-208
Dario Saric,PHI ," SF,PF",969,221,1196,2016-11-22,-748
DeMarre Carroll,TOR ," SF,PF",532,630,1167,2016-11-22,98
Allen Crabbe,POR ," PG,SG",759,403,1165,2016-11-22,-356
Nik Stauskas,PHI ," SG,SF",774,376,1152,2016-11-22,-398
Aaron Gordon,ORL ," SF,PF",984,148,1149,2016-11-22,-836
Lou Williams,LAL ," PG,SG",142,984,1143,2016-11-22,842
Jamal Murray,DEN , SG,244,8179,8423,2016-11-23,7935
Jerryd Bayless,PHI ," PG,SG",162,7385,7548,2016-11-23,7223
Marco Belinelli,CHA ," SG,SF",563,3077,3640,2016-11-23,2514
Frank Kaminsky,CHA ," PF,C",168,3263,3432,2016-11-23,3095
Nick Young,LAL ," SG,SF",300,2563,2870,2016-11-23,2263
Jonathan Gibson,DAL ," PG,SG",2717,119,2836,2016-11-23,-2598
Ersan Ilyasova,PHI ," SF,PF",132,2682,2817,2016-11-23,2550
DeMarre Carroll,TOR ," SF,PF",256,2553,2814,2016-11-23,2297
Alex Len,PHO ," PF,C",153,2599,2758,2016-11-23,2446
C.J. Miles,IND ," SG,SF",2059,687,2751,2016-11-23,-1372
Will Barton,DEN ," SG,SF",1919,807,2741,2016-11-23,-1112
Seth Curry,DAL ," PG,SG",1134,1580,2720,2016-11-23,446
Terrence Jones,NO ," SF,PF",259,2207,2477,2016-11-23,1948
Sergio Rodriguez,PHI , PG,2204,236,2450,2016-11-23,-1968
Alan Williams,PHO , PF,2209,213,2422,2016-11-23,-1996
Robert Covington,PHI ," SF,PF",376,1883,2269,2016-11-23,1507
T.J. Warren,PHO , SF,1785,249,2055,2016-11-23,-1536
Tim Frazier,NO ," PG,SG",82,1837,1935,2016-11-23,1755
Sean Kilpatrick,BKN ," PG,SG",1409,506,1927,2016-11-23,-903
Rondae Hollis-Jefferson,BKN ," SG,SF",1486,276,1766,2016-11-23,-1210
Maurice Harkless,POR , SF,438,1314,1765,2016-11-23,876
Greg Monroe,MIL ," PF,C",1135,540,1701,2016-11-23,-595
Brandon Jennings,NY , PG,262,1414,1677,2016-11-23,1152
Josh Richardson,MIA ," SG,SF",1457,185,1650,2016-11-23,-1272
Larry Nance Jr.,LAL , PF,750,893,1645,2016-11-23,143
Wilson Chandler,DEN ," SG,SF,PF",168,1435,1620,2016-11-23,1267
Dion Waiters,MIA ," SG,SF",694,879,1581,2016-11-23,185
Langston Galloway,NO ," PG,SG",1284,215,1501,2016-11-23,-1069
Ish Smith,DET , PG,747,737,1491,2016-11-23,-10
Dario Saric,PHI ," SF,PF",1274,151,1436,2016-11-23,-1123
Matt Barnes,SAC ," SG,SF",903,518,1427,2016-11-23,-385
Tyson Chandler,PHO , C,1058,345,1414,2016-11-23,-713
Tyler Johnson,MIA ," PG,SG",994,367,1374,2016-11-23,-627
Jusuf Nurkic,DEN , C,291,1065,1369,2016-11-23,774
Emmanuel Mudiay,DEN , PG,1136,213,1368,2016-11-23,-923
Jon Leuer,DET ," PF,C",603,741,1352,2016-11-23,138
Mike Muscala,ATL ," PF,C",1204,130,1339,2016-11-23,-1074
Spencer Hawes,CHA ," PF,C",303,963,1266,2016-11-23,660
Cody Zeller,CHA ," PF,C",900,344,1253,2016-11-23,-556
Tony Parker,SA , PG,721,510,1235,2016-11-23,-211
Chandler Parsons,MEM ," SF,PF",921,268,1207,2016-11-23,-653
Jose Calderon,LAL , PG,53,1152,1205,2016-11-23,1099
Bismack Biyombo,ORL ," PF,C",444,733,1185,2016-11-23,289
John Henson,MIL ," PF,C",1109,60,1173,2016-11-23,-1049
Channing Frye,CLE ," PF,C",547,610,1159,2016-11-23,63
K. Korver,CLE ," SG,SF",556,592,1159,2016-11-23,36
Allen Crabbe,POR ," PG,SG",1086,68,1157,2016-11-23,-1018
Vince Carter,MEM ," SG,SF",751,388,1148,2016-11-23,-363
J.J. Barea,DAL ," PG,SG",875,265,1141,2016-11-23,-610
JaMychal Green,MEM , PF,110,1022,1135,2016-11-23,912
Frank Kaminsky,CHA ," PF,C",242,6532,6775,2016-11-25,6290
Jerryd Bayless,PHI ," PG,SG",455,4646,5102,2016-11-25,4191
Jamal Murray,DEN , SG,284,4309,4600,2016-11-25,4025
Sergio Rodriguez,PHI , PG,4376,59,4448,2016-11-25,-4317
Marco Belinelli,CHA ," SG,SF",267,3348,3618,2016-11-25,3081
Will Barton,DEN ," SG,SF",3433,172,3614,2016-11-25,-3261
Ersan Ilyasova,PHI ," SF,PF",179,3074,3256,2016-11-25,2895
Cody Zeller,CHA ," PF,C",392,2760,3156,2016-11-25,2368
JaMychal Green,MEM , PF,123,2530,2657,2016-11-25,2407
T.J. Warren,PHO , SF,2322,157,2507,2016-11-25,-2165
Tyler Johnson,MIA ," SF,PF",95,2222,2319,2016-11-25,2127
John Henson,MIL ," PF,C",2205,44,2255,2016-11-25,-2161
Danny Green,SA ," SG,SF",93,1891,1996,2016-11-25,1798
Nick Young,LAL ," SG,SF",1729,196,1944,2016-11-25,-1533
Jonathan Gibson,DAL ," PG,SG",1846,74,1920,2016-11-25,-1772
Tyler Johnson,MIA ," PG,SG",295,1538,1843,2016-11-25,1243
Alex Len,PHO ," PF,C",201,1551,1763,2016-11-25,1350
Marvin Williams,CHA ," SF,PF",1286,447,1750,2016-11-25,-839
Seth Curry,DAL ," PG,SG",1511,141,1656,2016-11-25,-1370
DeMarre Carroll,TOR ," SF,PF",199,1418,1628,2016-11-25,1219
Jon Leuer,DET ," PF,C",376,1183,1568,2016-11-25,807
Sean Kilpatrick,BKN ," PG,SG",346,1212,1560,2016-11-25,866
Alan Williams,PHO , PF,1518,23,1543,2016-11-25,-1495
Maurice Harkless,POR , SF,363,1144,1516,2016-11-25,781
Deron Williams,DAL , PG,348,1106,1461,2016-11-25,758
Patty Mills,SA , PG,168,1274,1449,2016-11-25,1106
Greg Monroe,MIL ," PF,C",761,660,1448,2016-11-25,-101
Tyson Chandler,PHO , C,764,670,1439,2016-11-25,-94
Robert Covington,PHI ," SF,PF",666,737,1410,2016-11-25,71
Dario Saric,PHI ," SF,PF",1301,91,1404,2016-11-25,-1210
Terrence Jones,NO ," SF,PF",410,907,1332,2016-11-25,497
Mike Muscala,ATL ," PF,C",1187,131,1322,2016-11-25,-1056
C.J. Miles,IND ," SG,SF",1089,207,1307,2016-11-25,-882
Rondae Hollis-Jefferson,BKN ," SG,SF",1246,51,1306,2016-11-25,-1195
Dion Waiters,MIA ," SG,SF",339,945,1290,2016-11-25,606
Langston Galloway,NO ," PG,SG",1029,236,1268,2016-11-25,-793
Andrew Harrison,MEM ," PG,SG",35,1221,1256,2016-11-25,1186
Channing Frye,CLE ," PF,C",956,251,1211,2016-11-25,-705
Ish Smith,DET , PG,502,649,1161,2016-11-25,147
Wilson Chandler,DEN ," SG,SF,PF",148,953,1126,2016-11-25,805
Brandon Jennings,NY , PG,409,688,1099,2016-11-25,279
Larry Nance Jr.,LAL , PF,789,266,1061,2016-11-25,-523
Andre Roberson,OKC ," SG,SF",275,781,1057,2016-11-25,506
Spencer Hawes,CHA ," PF,C",751,300,1052,2016-11-25,-451
Tony Parker,SA , PG,662,376,1046,2016-11-25,-286
Kent Bazemore,ATL ," SG,SF",943,75,1030,2016-11-25,-868
Josh Richardson,MIA ," SG,SF",764,207,983,2016-11-25,-557
Michael Kidd-Gilchrist,CHA , SF,525,431,969,2016-11-25,-94
Bismack Biyombo,ORL ," PF,C",758,178,949,2016-11-25,-580
Patrick Beverley,HOU ," PG,SG",342,598,946,2016-11-25,256
Frank Kaminsky,CHA ," PF,C",1089,6865,7957,2016-11-26,5776
Jamal Murray,DEN , SG,147,6590,6743,2016-11-26,6443
Marco Belinelli,CHA ," SG,SF",2351,4287,6641,2016-11-26,1936
Ersan Ilyasova,PHI ," SF,PF",140,4656,4797,2016-11-26,4516
Glenn Robinson III,IND ," SG,SF",102,4332,4434,2016-11-26,4230
Will Barton,DEN ," SG,SF",3645,105,3771,2016-11-26,-3540
Sergio Rodriguez,PHI , PG,3563,77,3661,2016-11-26,-3486
Marvin Williams,CHA ," SF,PF",3278,102,3397,2016-11-26,-3176
Sean Kilpatrick,BKN ," PG,SG",276,2941,3222,2016-11-26,2665
Cody Zeller,CHA ," PF,C",561,2414,2980,2016-11-26,1853
Tyler Johnson,MIA ," SF,PF",926,2008,2936,2016-11-26,1082
JaMychal Green,MEM , PF,662,2165,2831,2016-11-26,1503
Maurice Harkless,POR , SF,205,2423,2636,2016-11-26,2218
Nik Stauskas,PHI ," SG,SF",139,2388,2529,2016-11-26,2249
Jeremy Lamb,CHA ," SG,SF",76,2381,2457,2016-11-26,2305
Tyler Johnson,MIA ," PG,SG",620,1706,2332,2016-11-26,1086
Dion Waiters,MIA ," SG,SF",537,1669,2219,2016-11-26,1132
Jon Leuer,DET ," PF,C",1079,1098,2186,2016-11-26,19
Nick Young,LAL ," SG,SF",1930,208,2166,2016-11-26,-1722
Jameer Nelson,DEN , PG,92,1912,2004,2016-11-26,1820
John Henson,MIL ," PF,C",1936,37,1976,2016-11-26,-1899
Joakim Noah,NY ," PF,C",1549,366,1920,2016-11-26,-1183
T.J. Warren,PHO , SF,1627,248,1894,2016-11-26,-1379
Jerryd Bayless,PHI ," PG,SG",1023,811,1840,2016-11-26,-212
Danny Green,SA ," SG,SF",508,1250,1772,2016-11-26,742
Wilson Chandler,DEN ," SG,SF,PF",53,1668,1742,2016-11-26,1615
Dario Saric,PHI ," SF,PF",1579,116,1705,2016-11-26,-1463
C.J. Miles,IND ," SG,SF",1405,234,1646,2016-11-26,-1171
Ish Smith,DET , PG,983,646,1639,2016-11-26,-337
Andre Roberson,OKC ," SG,SF",1390,244,1635,2016-11-26,-1146
Patrick Beverley,HOU ," PG,SG",252,1369,1625,2016-11-26,1117
Alex Len,PHO ," PF,C",321,1244,1579,2016-11-26,923
Seth Curry,DAL ," PG,SG",1295,269,1578,2016-11-26,-1026
Tyson Chandler,PHO , C,868,697,1578,2016-11-26,-171
Jonathan Gibson,DAL ," PG,SG",1465,97,1564,2016-11-26,-1368
Patty Mills,SA , PG,628,900,1530,2016-11-26,272
Vince Carter,MEM ," SG,SF",1364,147,1512,2016-11-26,-1217
E'Twaun Moore,NO ," PG,SG",175,1319,1499,2016-11-26,1144
Greg Monroe,MIL ," PF,C",459,972,1448,2016-11-26,513
Langston Galloway,NO ," PG,SG",937,491,1431,2016-11-26,-446
Terrence Jones,NO ," SF,PF",312,1113,1429,2016-11-26,801
Michael Kidd-Gilchrist,CHA , SF,1040,335,1396,2016-11-26,-705
Trevor Booker,BKN , PF,63,1312,1392,2016-11-26,1249
Alan Williams,PHO , PF,1296,39,1337,2016-11-26,-1257
Mike Muscala,ATL ," PF,C",1141,181,1326,2016-11-26,-960
Rondae Hollis-Jefferson,BKN ," SG,SF",1200,92,1299,2016-11-26,-1108
Deron Williams,DAL , PG,319,963,1289,2016-11-26,644
Andrew Bogut,DAL , C,262,1010,1274,2016-11-26,748
Larry Nance Jr.,LAL , PF,718,541,1262,2016-11-26,-177
DeMarre Carroll,TOR ," SF,PF",333,900,1246,2016-11-26,567
JaMychal Green,MEM , PF,440,7994,8440,2016-11-27,7554
Dion Waiters,MIA ," SG,SF",387,5408,5800,2016-11-27,5021
Will Barton,DEN ," SG,SF",4358,101,4470,2016-11-27,-4257
Frank Kaminsky,CHA ," PF,C",924,3402,4332,2016-11-27,2478
Jamal Murray,DEN , SG,1191,2990,4186,2016-11-27,1799
Ersan Ilyasova,PHI ," SF,PF",271,3535,3810,2016-11-27,3264
Troy Williams,MEM ," SG,SF,PF",74,3720,3794,2016-11-27,3646
Marco Belinelli,CHA ," SG,SF",3339,227,3569,2016-11-27,-3112
Sean Kilpatrick,BKN ," PG,SG",412,2825,3239,2016-11-27,2413
Cody Zeller,CHA ," PF,C",517,2453,2974,2016-11-27,1936
Marvin Williams,CHA ," SF,PF",2755,73,2840,2016-11-27,-2682
Jeremy Lamb,CHA ," SG,SF",158,2680,2838,2016-11-27,2522
Tyler Johnson,MIA ," SF,PF",728,1991,2721,2016-11-27,1263
Tyson Chandler,PHO , C,473,2239,2719,2016-11-27,1766
Glenn Robinson III,IND ," SG,SF",646,2042,2688,2016-11-27,1396
Jerryd Bayless,PHI ," PG,SG",2079,342,2426,2016-11-27,-1737
Maurice Harkless,POR , SF,339,1823,2171,2016-11-27,1484
Terrence Jones,NO ," SF,PF",1287,770,2067,2016-11-27,-517
Jonathan Gibson,DAL ," PG,SG",1939,66,2007,2016-11-27,-1873
Tyler Johnson,MIA ," PG,SG",722,1235,1967,2016-11-27,513
Jameer Nelson,DEN , PG,311,1594,1905,2016-11-27,1283
Sergio Rodriguez,PHI , PG,1044,846,1897,2016-11-27,-198
DeMarre Carroll,TOR ," SF,PF",252,1636,1893,2016-11-27,1384
Alex Len,PHO ," PF,C",1041,830,1878,2016-11-27,-211
Patrick Beverley,HOU ," PG,SG",777,1015,1804,2016-11-27,238
Joakim Noah,NY ," PF,C",1682,102,1787,2016-11-27,-1580
Nik Stauskas,PHI ," SG,SF",228,1525,1755,2016-11-27,1297
Wilson Chandler,DEN ," SG,SF,PF",65,1652,1731,2016-11-27,1587
Seth Curry,DAL ," PG,SG",1430,232,1664,2016-11-27,-1198
Patrick Patterson,TOR ," PF,C",126,1530,1657,2016-11-27,1404
Jon Leuer,DET ," PF,C",1275,371,1649,2016-11-27,-904
T.J. Warren,PHO , SF,1236,318,1565,2016-11-27,-918
John Henson,MIL ," PF,C",604,959,1564,2016-11-27,355
J.R. Smith,CLE ," SG,SF",1282,243,1532,2016-11-27,-1039
C.J. Miles,IND ," SG,SF",1275,210,1487,2016-11-27,-1065
E'Twaun Moore,NO ," PG,SG",759,658,1420,2016-11-27,-101
Thabo Sefolosha,ATL ," SG,SF",640,732,1377,2016-11-27,92
Nick Young,LAL ," SG,SF",772,585,1369,2016-11-27,-187
Marcus Morris,DET ," SF,PF",1078,229,1330,2016-11-27,-849
Aaron Gordon,ORL ," SF,PF",942,365,1328,2016-11-27,-577
Ish Smith,DET , PG,959,354,1326,2016-11-27,-605
Dario Saric,PHI ," SF,PF",1172,134,1311,2016-11-27,-1038
Andrew Bogut,DAL , C,391,915,1310,2016-11-27,524
Evan Turner,POR ," SG,SF",331,954,1287,2016-11-27,623
Rondae Hollis-Jefferson,BKN ," SG,SF",1115,153,1274,2016-11-27,-962
Jared Dudley,PHO ," SG,SF,PF",1213,58,1273,2016-11-27,-1155
Patty Mills,SA , PG,485,778,1268,2016-11-27,293
Greg Monroe,MIL ," PF,C",422,818,1266,2016-11-27,396
Langston Galloway,NO ," PG,SG",992,263,1258,2016-11-27,-729
Michael Kidd-Gilchrist,CHA , SF,861,387,1256,2016-11-27,-474
Sean Kilpatrick,BKN ," PG,SG",275,10273,10554,2016-11-28,9998
Jeremy Lamb,CHA ," SG,SF",233,8281,8514,2016-11-28,8048
JaMychal Green,MEM , PF,1488,5697,7187,2016-11-28,4209
Will Barton,DEN ," SG,SF",6594,75,6676,2016-11-28,-6519
John Henson,MIL ," PF,C",216,5243,5463,2016-11-28,5027
Frank Kaminsky,CHA ," PF,C",344,4823,5175,2016-11-28,4479
Tyson Chandler,PHO , C,267,4323,4600,2016-11-28,4056
Jerryd Bayless,PHI ," PG,SG",4364,153,4527,2016-11-28,-4211
Cody Zeller,CHA ," PF,C",551,3560,4115,2016-11-28,3009
Ersan Ilyasova,PHI ," SF,PF",797,3049,3855,2016-11-28,2252
Dion Waiters,MIA ," SG,SF",1791,1831,3627,2016-11-28,40
Maurice Harkless,POR , SF,520,2942,3471,2016-11-28,2422
Jamal Murray,DEN , SG,1997,1168,3173,2016-11-28,-829
Larry Nance Jr.,LAL , PF,356,2774,3131,2016-11-28,2418
Sergio Rodriguez,PHI , PG,591,2327,2930,2016-11-28,1736
Marco Belinelli,CHA ," SG,SF",2510,375,2888,2016-11-28,-2135
Marvin Williams,CHA ," SF,PF",2731,116,2861,2016-11-28,-2615
Tyler Johnson,MIA ," SF,PF",1070,1775,2845,2016-11-28,705
Jameer Nelson,DEN , PG,365,2380,2746,2016-11-28,2015
Nick Young,LAL ," SG,SF",415,2196,2629,2016-11-28,1781
Troy Williams,MEM ," SG,SF,PF",472,2079,2551,2016-11-28,1607
Patty Mills,SA , PG,271,2273,2545,2016-11-28,2002
DeMarre Carroll,TOR ," SF,PF",304,2116,2431,2016-11-28,1812
Wilson Chandler,DEN ," SG,SF,PF",73,2215,2312,2016-11-28,2142
Seth Curry,DAL ," PG,SG",2084,201,2291,2016-11-28,-1883
Jonathan Gibson,DAL ," PG,SG",2257,20,2278,2016-11-28,-2237
Tyler Johnson,MIA ," PG,SG",1244,972,2229,2016-11-28,-272
Nik Stauskas,PHI ," SG,SF",879,1280,2160,2016-11-28,401
Alex Len,PHO ," PF,C",1248,841,2099,2016-11-28,-407
Terrence Jones,NO ," SF,PF",1548,500,2067,2016-11-28,-1048
T.J. Warren,PHO , SF,1551,474,2037,2016-11-28,-1077
C.J. Miles,IND ," SG,SF",1515,510,2027,2016-11-28,-1005
Dario Saric,PHI ," SF,PF",1810,166,1981,2016-11-28,-1644
Patrick Beverley,HOU ," PG,SG",1402,469,1880,2016-11-28,-933
Ish Smith,DET , PG,684,1176,1872,2016-11-28,492
Jon Leuer,DET ," PF,C",818,1012,1841,2016-11-28,194
Patrick Patterson,TOR ," PF,C",418,1387,1806,2016-11-28,969
Jared Dudley,PHO ," SG,SF,PF",1763,10,1776,2016-11-28,-1753
Glenn Robinson III,IND ," SG,SF",900,857,1757,2016-11-28,-43
Rondae Hollis-Jefferson,BKN ," SG,SF",1571,135,1709,2016-11-28,-1436
Matt Barnes,SAC ," SG,SF",1288,405,1695,2016-11-28,-883
Aaron Gordon,ORL ," SF,PF",1287,356,1660,2016-11-28,-931
J.R. Smith,CLE ," SG,SF",1338,294,1649,2016-11-28,-1044
Josh Richardson,MIA ," SG,SF",502,1075,1586,2016-11-28,573
Matthew Dellavedova,MIL ," PG,SG",686,871,1560,2016-11-28,185
Langston Galloway,NO ," PG,SG",1338,201,1542,2016-11-28,-1137
Evan Turner,POR ," SG,SF",562,967,1531,2016-11-28,405
Brandon Jennings,NY , PG,978,551,1530,2016-11-28,-427
Thabo Sefolosha,ATL ," SG,SF",1276,250,1528,2016-11-28,-1026
Dirk Nowitzki,DAL ," PF,C",1394,93,1499,2016-11-28,-1301
Andrew Harrison,MEM ," PG,SG",390,15958,16348,2016-11-29,15568
Jeremy Lamb,CHA ," SG,SF",3967,9824,13791,2016-11-29,5857
Sean Kilpatrick,BKN ," PG,SG",719,8439,9161,2016-11-29,7720
Nick Young,LAL ," SG,SF",4074,1553,5636,2016-11-29,-2521
John Henson,MIL ," PF,C",646,3875,4522,2016-11-29,3229
Frank Kaminsky,CHA ," PF,C",2432,1919,4358,2016-11-29,-513
Dion Waiters,MIA ," SG,SF",3916,329,4248,2016-11-29,-3587
Sergio Rodriguez,PHI , PG,624,3290,3917,2016-11-29,2666
Mike Conley,MEM , PG,3469,67,3547,2016-11-29,-3402
Jameer Nelson,DEN , PG,374,2822,3196,2016-11-29,2448
Will Barton,DEN ," SG,SF",2662,402,3067,2016-11-29,-2260
Ersan Ilyasova,PHI ," SF,PF",881,2162,3048,2016-11-29,1281
Wade Baldwin IV,MEM , PG,163,2863,3026,2016-11-29,2700
Jerryd Bayless,PHI ," PG,SG",2822,200,3025,2016-11-29,-2622
Tyson Chandler,PHO , C,243,2772,3025,2016-11-29,2529
Courtney Lee,NY ," SG,SF",307,2685,2994,2016-11-29,2378
JaMychal Green,MEM , PF,1897,1016,2913,2016-11-29,-881
Larry Nance Jr.,LAL , PF,690,2033,2726,2016-11-29,1343
Maurice Harkless,POR , SF,212,2470,2687,2016-11-29,2258
Terrence Ross,TOR ," SG,SF",226,2380,2609,2016-11-29,2154
Marco Belinelli,CHA ," SG,SF",2111,299,2414,2016-11-29,-1812
DeMarre Carroll,TOR ," SF,PF",244,2131,2383,2016-11-29,1887
Patty Mills,SA , PG,473,1782,2258,2016-11-29,1309
Jamal Murray,DEN , SG,1153,989,2148,2016-11-29,-164
Cody Zeller,CHA ," PF,C",1235,907,2147,2016-11-29,-328
Terrence Jones,NO ," SF,PF",1676,298,1986,2016-11-29,-1378
Robert Covington,PHI ," SF,PF",241,1733,1979,2016-11-29,1492
C.J. Miles,IND ," SG,SF",995,980,1977,2016-11-29,-15
Tyler Johnson,MIA ," SF,PF",1360,573,1933,2016-11-29,-787
Nik Stauskas,PHI ," SG,SF",862,1015,1879,2016-11-29,153
Marvin Williams,CHA ," SF,PF",1728,136,1871,2016-11-29,-1592
Ish Smith,DET , PG,869,973,1852,2016-11-29,104
Seth Curry,DAL ," PG,SG",1467,347,1818,2016-11-29,-1120
K. Korver,CLE ," SG,SF",1630,161,1800,2016-11-29,-1469
Tony Parker,SA , PG,814,964,1783,2016-11-29,150
E'Twaun Moore,NO ," PG,SG",1461,222,1685,2016-11-29,-1239
Josh Richardson,MIA ," SG,SF",610,1064,1680,2016-11-29,454
Tyler Johnson,MIA ," PG,SG",1230,434,1670,2016-11-29,-796
Dirk Nowitzki,DAL ," PF,C",1568,84,1664,2016-11-29,-1484
Jon Leuer,DET ," PF,C",528,1019,1553,2016-11-29,491
Patrick Beverley,HOU ," PG,SG",1206,336,1551,2016-11-29,-870
Dario Saric,PHI ," SF,PF",1378,143,1525,2016-11-29,-1235
Alex Len,PHO ," PF,C",390,1120,1518,2016-11-29,730
T.J. Warren,PHO , SF,1154,351,1512,2016-11-29,-803
Matthew Dellavedova,MIL ," PG,SG",811,687,1507,2016-11-29,-124
Andrew Bogut,DAL , C,313,1169,1488,2016-11-29,856
J.R. Smith,CLE ," SG,SF",1165,310,1481,2016-11-29,-855
Danny Green,SA ," SG,SF",537,921,1467,2016-11-29,384
Wilson Chandler,DEN ," SG,SF,PF",56,1374,1439,2016-11-29,1318
Greg Monroe,MIL ," PF,C",394,992,1406,2016-11-29,598
Andrew Harrison,MEM ," PG,SG",232,12021,12253,2016-11-30,11789
Nick Young,LAL ," SG,SF",10407,152,10568,2016-11-30,-10255
Sean Kilpatrick,BKN ," PG,SG",125,9511,9643,2016-11-30,9386
Jeremy Lamb,CHA ," SG,SF",5791,208,5999,2016-11-30,-5583
John Henson,MIL ," PF,C",503,5104,5609,2016-11-30,4601
D.J. Augustin,ORL , PG,221,4317,4539,2016-11-30,4096
Dion Waiters,MIA ," SG,SF",3823,184,4012,2016-11-30,-3639
Jameer Nelson,DEN , PG,343,3283,3626,2016-11-30,2940
Jerryd Bayless,PHI ," PG,SG",3222,183,3409,2016-11-30,-3039
Jamal Murray,DEN , SG,2557,815,3383,2016-11-30,-1742
Frank Kaminsky,CHA ," PF,C",2051,735,2790,2016-11-30,-1316
Brandon Ingram,LAL ," SG,SF",411,2341,2757,2016-11-30,1930
Channing Frye,CLE ," PF,C",332,2317,2655,2016-11-30,1985
Maurice Harkless,POR , SF,267,2335,2613,2016-11-30,2068
Courtney Lee,NY ," SG,SF",1067,1499,2571,2016-11-30,432
Will Barton,DEN ," SG,SF",1911,487,2409,2016-11-30,-1424
Ersan Ilyasova,PHI ," SF,PF",605,1634,2247,2016-11-30,1029
Dirk Nowitzki,DAL ," PF,C",2059,158,2236,2016-11-30,-1901
Terrence Ross,TOR ," SG,SF",694,1500,2197,2016-11-30,806
Tyson Chandler,PHO , C,500,1682,2191,2016-11-30,1182
Sergio Rodriguez,PHI , PG,596,1507,2109,2016-11-30,911
Cody Zeller,CHA ," PF,C",673,1415,2095,2016-11-30,742
Tyler Johnson,MIA ," PG,SG",450,1581,2034,2016-11-30,1131
Nerlens Noel,PHI ," PF,C",295,1701,2002,2016-11-30,1406
Larry Nance Jr.,LAL , PF,785,1182,1967,2016-11-30,397
Terrence Jones,NO ," SF,PF",1702,248,1958,2016-11-30,-1454
Josh Richardson,MIA ," SG,SF",1259,662,1924,2016-11-30,-597
JaMychal Green,MEM , PF,509,1400,1913,2016-11-30,891
Tim Frazier,NO ," PG,SG",1748,127,1896,2016-11-30,-1621
Seth Curry,DAL ," PG,SG",1288,598,1892,2016-11-30,-690
DeMarre Carroll,TOR ," SF,PF",281,1547,1835,2016-11-30,1266
Marco Belinelli,CHA ," SG,SF",706,1106,1814,2016-11-30,400
Ish Smith,DET , PG,736,1054,1798,2016-11-30,318
Mike Conley,MEM , PG,1716,61,1793,2016-11-30,-1655
Joakim Noah,NY ," PF,C",1576,177,1763,2016-11-30,-1399
Wayne Ellington,MIA ," SG,SF",23,1730,1753,2016-11-30,1707
Tony Parker,SA , PG,1530,186,1722,2016-11-30,-1344
J.R. Smith,CLE ," SG,SF",1344,362,1719,2016-11-30,-982
Patty Mills,SA , PG,718,975,1695,2016-11-30,257
Greg Monroe,MIL ," PF,C",228,1430,1676,2016-11-30,1202
Andrew Bogut,DAL , C,194,1463,1667,2016-11-30,1269
Alex Len,PHO ," PF,C",560,1067,1640,2016-11-30,507
C.J. Miles,IND ," SG,SF",757,855,1616,2016-11-30,98
Glenn Robinson III,IND ," SG,SF",605,995,1601,2016-11-30,390
Patrick Beverley,HOU ," PG,SG",1166,388,1564,2016-11-30,-778
Nik Stauskas,PHI ," SG,SF",473,1070,1544,2016-11-30,597
E'Twaun Moore,NO ," PG,SG",1453,31,1486,2016-11-30,-1422
K. Korver,CLE ," SG,SF",1295,156,1459,2016-11-30,-1139
Evan Turner,POR ," SG,SF",281,1163,1447,2016-11-30,882
Matthew Dellavedova,MIL ," PG,SG",721,692,1417,2016-11-30,-29
Patrick Patterson,TOR ," PF,C",185,8876,9062,2016-12-01,8691
Andrew Harrison,MEM ," PG,SG",402,7740,8142,2016-12-01,7338
Wayne Ellington,MIA ," SG,SF",239,6932,7171,2016-12-01,6693
Nick Young,LAL ," SG,SF",5649,58,5729,2016-12-01,-5591
Frank Kaminsky,CHA ," PF,C",4929,379,5314,2016-12-01,-4550
Jameer Nelson,DEN , PG,241,4832,5076,2016-12-01,4591
John Henson,MIL ," PF,C",471,4396,4871,2016-12-01,3925
Josh Richardson,MIA ," SG,SF",3508,50,3566,2016-12-01,-3458
Dion Waiters,MIA ," SG,SF",3295,121,3425,2016-12-01,-3174
Jamal Murray,DEN , SG,2934,430,3379,2016-12-01,-2504
Patty Mills,SA , PG,310,2598,2916,2016-12-01,2288
Sean Kilpatrick,BKN ," PG,SG",277,2490,2782,2016-12-01,2213
Ish Smith,DET , PG,318,2341,2667,2016-12-01,2023
Tyler Johnson,MIA ," PG,SG",393,2256,2659,2016-12-01,1863
Larry Nance Jr.,LAL , PF,289,2206,2499,2016-12-01,1917
Jerryd Bayless,PHI ," PG,SG",2287,105,2396,2016-12-01,-2182
Seth Curry,DAL ," PG,SG",2158,109,2281,2016-12-01,-2049
Will Barton,DEN ," SG,SF",1634,605,2253,2016-12-01,-1029
Maurice Harkless,POR , SF,207,1959,2188,2016-12-01,1752
JaMychal Green,MEM , PF,703,1441,2155,2016-12-01,738
Kelly Olynyk,BOS , C,94,1997,2094,2016-12-01,1903
Tyler Johnson,MIA ," SF,PF",426,1657,2087,2016-12-01,1231
Brandon Ingram,LAL ," SG,SF",365,1606,1981,2016-12-01,1241
Ben Simmons,PHI ," SF,PF",103,1807,1914,2016-12-01,1704
Jeremy Lamb,CHA ," SG,SF",1700,207,1912,2016-12-01,-1493
Cody Zeller,CHA ," PF,C",1023,832,1871,2016-12-01,-191
Channing Frye,CLE ," PF,C",617,1233,1850,2016-12-01,616
Dirk Nowitzki,DAL ," PF,C",1562,238,1822,2016-12-01,-1324
Nerlens Noel,PHI ," PF,C",171,1588,1761,2016-12-01,1417
Ersan Ilyasova,PHI ," SF,PF",623,1099,1728,2016-12-01,476
D.J. Augustin,ORL , PG,695,1026,1724,2016-12-01,331
Joakim Noah,NY ," PF,C",1609,42,1657,2016-12-01,-1567
Andrew Bogut,DAL , C,1012,600,1620,2016-12-01,-412
Deron Williams,DAL , PG,454,1096,1556,2016-12-01,642
Marco Belinelli,CHA ," SG,SF",1081,425,1510,2016-12-01,-656
J.R. Smith,CLE ," SG,SF",1119,353,1491,2016-12-01,-766
Jon Leuer,DET ," PF,C",381,1087,1475,2016-12-01,706
Evan Turner,POR ," SG,SF",247,1212,1463,2016-12-01,965
Courtney Lee,NY ," SG,SF",1342,106,1453,2016-12-01,-1236
Jusuf Nurkic,DEN , C,1324,96,1441,2016-12-01,-1228
Sergio Rodriguez,PHI , PG,575,848,1430,2016-12-01,273
K. Korver,CLE ," SG,SF",1231,172,1421,2016-12-01,-1059
Marcus Morris,DET ," SF,PF",132,1252,1404,2016-12-01,1120
Tyson Chandler,PHO , C,732,650,1403,2016-12-01,-82
Terrence Jones,NO ," SF,PF",1118,228,1355,2016-12-01,-890
Patrick Beverley,HOU ," PG,SG",961,372,1341,2016-12-01,-589
Tony Parker,SA , PG,1221,111,1338,2016-12-01,-1110
Greg Monroe,MIL ," PF,C",559,708,1286,2016-12-01,149
Thabo Sefolosha,ATL ," SG,SF",225,1055,1285,2016-12-01,830
Nik Stauskas,PHI ," SG,SF",482,775,1260,2016-12-01,293
John Henson,MIL ," PF,C",236,7240,7484,2016-12-02,7004
Will Barton,DEN ," SG,SF",472,6457,6931,2016-12-02,5985
Tyler Johnson,MIA ," SF,PF",215,6709,6926,2016-12-02,6494
Wayne Ellington,MIA ," SG,SF",601,4796,5397,2016-12-02,4195
Frank Kaminsky,CHA ," PF,C",4561,177,4746,2016-12-02,-4384
Ben Simmons,PHI ," SF,PF",122,3591,3716,2016-12-02,3469
Jameer Nelson,DEN , PG,1401,2273,3676,2016-12-02,872
Jamal Murray,DEN , SG,3094,294,3394,2016-12-02,-2800
Patrick Patterson,TOR ," PF,C",639,2590,3231,2016-12-02,1951
Nick Young,LAL ," SG,SF",2643,112,2769,2016-12-02,-2531
Brandon Ingram,LAL ," SG,SF",243,2055,2313,2016-12-02,1812
Patty Mills,SA , PG,435,1628,2074,2016-12-02,1193
Ish Smith,DET , PG,352,1580,1941,2016-12-02,1228
Larry Nance Jr.,LAL , PF,674,1213,1892,2016-12-02,539
Ersan Ilyasova,PHI ," SF,PF",1191,677,1878,2016-12-02,-514
Andrew Harrison,MEM ," PG,SG",589,1274,1866,2016-12-02,685
Josh Richardson,MIA ," SG,SF",1787,48,1842,2016-12-02,-1739
JaMychal Green,MEM , PF,668,1007,1685,2016-12-02,339
Rondae Hollis-Jefferson,BKN ," SG,SF",378,1283,1666,2016-12-02,905
Dion Waiters,MIA ," SG,SF",1490,126,1622,2016-12-02,-1364
Sean Kilpatrick,BKN ," PG,SG",379,1197,1597,2016-12-02,818
Nik Stauskas,PHI ," SG,SF",1154,384,1543,2016-12-02,-770
Elfrid Payton,ORL , PG,1376,119,1518,2016-12-02,-1257
Tyler Johnson,MIA ," PG,SG",589,913,1513,2016-12-02,324
Maurice Harkless,POR , SF,91,1405,1513,2016-12-02,1314
Seth Curry,DAL ," PG,SG",1436,71,1512,2016-12-02,-1365
J.R. Smith,CLE ," SG,SF",1283,208,1507,2016-12-02,-1075
Channing Frye,CLE ," PF,C",1313,186,1500,2016-12-02,-1127
D.J. Augustin,ORL , PG,1350,109,1461,2016-12-02,-1241
Cody Zeller,CHA ," PF,C",930,512,1453,2016-12-02,-418
Deron Williams,DAL , PG,232,1179,1418,2016-12-02,947
Evan Turner,POR ," SG,SF",185,1208,1400,2016-12-02,1023
Dario Saric,PHI ," SF,PF",1281,105,1391,2016-12-02,-1176
Kelly Olynyk,BOS , C,434,951,1385,2016-12-02,517
Jeremy Lamb,CHA ," SG,SF",764,591,1361,2016-12-02,-173
Danny Green,SA ," SG,SF",1201,113,1331,2016-12-02,-1088
Troy Daniels,MEM ," PG,SG",61,1243,1304,2016-12-02,1182
Patrick Beverley,HOU ," PG,SG",1023,207,1236,2016-12-02,-816
Mike Conley,MEM , PG,459,729,1226,2016-12-02,270
Tony Parker,SA , PG,1152,68,1224,2016-12-02,-1084
Dirk Nowitzki,DAL ," PF,C",934,250,1203,2016-12-02,-684
Robert Covington,PHI ," SF,PF",730,448,1187,2016-12-02,-282
K. Korver,CLE ," SG,SF",974,171,1162,2016-12-02,-803
Jerryd Bayless,PHI ," PG,SG",1054,103,1159,2016-12-02,-951
Terrence Jones,NO ," SF,PF",907,242,1156,2016-12-02,-665
Jon Leuer,DET ," PF,C",331,813,1147,2016-12-02,482
Marcus Smart,BOS , PG,851,220,1085,2016-12-02,-631
Joakim Noah,NY ," PF,C",1014,49,1075,2016-12-02,-965
Marco Belinelli,CHA ," SG,SF",858,213,1073,2016-12-02,-645
Matthew Dellavedova,MIL ," PG,SG",841,209,1060,2016-12-02,-632
Will Barton,DEN ," SG,SF",332,11037,11370,2016-12-03,10705
John Henson,MIL ," PF,C",345,5616,5962,2016-12-03,5271
Troy Daniels,MEM ," PG,SG",134,5814,5948,2016-12-03,5680
Jamal Murray,DEN , SG,5738,128,5872,2016-12-03,-5610
Jameer Nelson,DEN , PG,4579,111,4693,2016-12-03,-4468
Ish Smith,DET , PG,246,3929,4181,2016-12-03,3683
Matt Barnes,SAC ," SG,SF",215,3727,3942,2016-12-03,3512
Sam Dekker,HOU ," SF,PF",228,3659,3887,2016-12-03,3431
Tyler Johnson,MIA ," SF,PF",1312,2446,3759,2016-12-03,1134
Andre Roberson,OKC ," SG,SF",158,3384,3545,2016-12-03,3226
Wayne Ellington,MIA ," SG,SF",1000,2280,3280,2016-12-03,1280
Brandon Ingram,LAL ," SG,SF",408,2761,3176,2016-12-03,2353
Jon Leuer,DET ," PF,C",196,2920,3127,2016-12-03,2724
Glenn Robinson III,IND ," SG,SF",307,2298,2607,2016-12-03,1991
Andrew Harrison,MEM ," PG,SG",1991,558,2554,2016-12-03,-1433
Patty Mills,SA , PG,420,1971,2396,2016-12-03,1551
Dirk Nowitzki,DAL ," PF,C",2057,306,2384,2016-12-03,-1751
Ersan Ilyasova,PHI ," SF,PF",2052,217,2277,2016-12-03,-1835
Larry Nance Jr.,LAL , PF,1987,230,2221,2016-12-03,-1757
Patrick Patterson,TOR ," PF,C",1360,714,2077,2016-12-03,-646
Frank Kaminsky,CHA ," PF,C",1724,314,2045,2016-12-03,-1410
Kyle O'Quinn,NY ," PF,C",84,1885,1970,2016-12-03,1801
Nick Young,LAL ," SG,SF",1798,150,1958,2016-12-03,-1648
Marcus Smart,BOS , PG,1861,85,1956,2016-12-03,-1776
Nik Stauskas,PHI ," SG,SF",1812,70,1887,2016-12-03,-1742
Seth Curry,DAL ," PG,SG",1800,62,1865,2016-12-03,-1738
Elfrid Payton,ORL , PG,1617,170,1806,2016-12-03,-1447
Jamal Crawford,LAC ," SG,SF",264,1465,1737,2016-12-03,1201
Jeremy Lamb,CHA ," SG,SF",1246,465,1713,2016-12-03,-781
Dario Saric,PHI ," SF,PF",1153,513,1671,2016-12-03,-640
K. Korver,CLE ," SG,SF",1547,112,1669,2016-12-03,-1435
JaMychal Green,MEM , PF,546,1105,1658,2016-12-03,559
Bismack Biyombo,ORL ," PF,C",465,1143,1613,2016-12-03,678
Terrence Jones,NO ," SF,PF",529,1048,1590,2016-12-03,519
Evan Turner,POR ," SG,SF",351,1230,1584,2016-12-03,879
Jodie Meeks,ORL , SG,42,1530,1572,2016-12-03,1488
Robert Covington,PHI ," SF,PF",1456,66,1529,2016-12-03,-1390
Jusuf Nurkic,DEN , C,1354,160,1524,2016-12-03,-1194
Nikola Mirotic,CHI ," SF,PF",1141,354,1505,2016-12-03,-787
Tony Parker,SA , PG,1451,39,1494,2016-12-03,-1412
Deron Williams,DAL , PG,220,1236,1465,2016-12-03,1016
Danny Green,SA ," SG,SF",1338,64,1422,2016-12-03,-1274
Tyson Chandler,PHO , C,734,673,1420,2016-12-03,-61
Alex Len,PHO ," PF,C",1011,381,1412,2016-12-03,-630
Cody Zeller,CHA ," PF,C",905,489,1401,2016-12-03,-416
Tim Frazier,NO ," PG,SG",946,411,1377,2016-12-03,-535
Dion Waiters,MIA ," SG,SF",1241,104,1347,2016-12-03,-1137
Sean Kilpatrick,BKN ," PG,SG",688,617,1323,2016-12-03,-71
Josh Richardson,MIA ," SG,SF",1234,37,1282,2016-12-03,-1197
Rondae Hollis-Jefferson,BKN ," SG,SF",400,862,1270,2016-12-03,462
Troy Daniels,MEM ," PG,SG",220,15576,15796,2016-12-04,15356
John Henson,MIL ," PF,C",212,6414,6631,2016-12-04,6202
Will Barton,DEN ," SG,SF",256,5454,5716,2016-12-04,5198
JaMychal Green,MEM , PF,217,4604,4827,2016-12-04,4387
Ish Smith,DET , PG,3183,1468,4659,2016-12-04,-1715
Jamal Murray,DEN , SG,4513,69,4590,2016-12-04,-4444
Tim Frazier,NO ," PG,SG",3580,337,3934,2016-12-04,-3243
Matt Barnes,SAC ," SG,SF",1706,2009,3716,2016-12-04,303
Andre Roberson,OKC ," SG,SF",539,2799,3343,2016-12-04,2260
Glenn Robinson III,IND ," SG,SF",1807,1486,3293,2016-12-04,-321
Andrew Harrison,MEM ," PG,SG",2739,251,2996,2016-12-04,-2488
Wayne Ellington,MIA ," SG,SF",1128,1549,2679,2016-12-04,421
Lucas Nogueira,TOR ," PF,C",177,2444,2622,2016-12-04,2267
Jon Leuer,DET ," PF,C",603,1917,2532,2016-12-04,1314
C.J. Miles,IND ," SG,SF",559,1733,2294,2016-12-04,1174
Sergio Rodriguez,PHI , PG,390,1859,2256,2016-12-04,1469
Tyler Johnson,MIA ," SF,PF",1879,343,2226,2016-12-04,-1536
Nikola Mirotic,CHI ," SF,PF",2056,114,2179,2016-12-04,-1942
Patrick Patterson,TOR ," PF,C",608,1529,2139,2016-12-04,921
Patty Mills,SA , PG,314,1811,2135,2016-12-04,1497
Alex Len,PHO ," PF,C",1904,163,2083,2016-12-04,-1741
Tyson Chandler,PHO , C,1764,225,2003,2016-12-04,-1539
Frank Kaminsky,CHA ," PF,C",649,1326,1980,2016-12-04,677
Elfrid Payton,ORL , PG,1706,221,1943,2016-12-04,-1485
Jusuf Nurkic,DEN , C,1718,121,1850,2016-12-04,-1597
Terrence Jones,NO ," SF,PF",1083,709,1804,2016-12-04,-374
Dwight Powell,DAL ," PF,C",70,1730,1801,2016-12-04,1660
K. Korver,CLE ," SG,SF",1571,111,1693,2016-12-04,-1460
Seth Curry,DAL ," PG,SG",1623,51,1677,2016-12-04,-1572
Nick Young,LAL ," SG,SF",1491,146,1642,2016-12-04,-1345
Jamal Crawford,LAC ," SG,SF",733,869,1611,2016-12-04,136
Maurice Harkless,POR , SF,220,1360,1599,2016-12-04,1140
Dirk Nowitzki,DAL ," PF,C",1246,310,1570,2016-12-04,-936
Jeremy Lamb,CHA ," SG,SF",1491,70,1566,2016-12-04,-1421
Marcus Smart,BOS , PG,1426,86,1519,2016-12-04,-1340
Cody Zeller,CHA ," PF,C",789,705,1501,2016-12-04,-84
Larry Nance Jr.,LAL , PF,1395,98,1494,2016-12-04,-1297
Evan Turner,POR ," SG,SF",443,1044,1490,2016-12-04,601
Deron Williams,DAL , PG,294,1188,1488,2016-12-04,894
Sean Kilpatrick,BKN ," PG,SG",688,769,1475,2016-12-04,81
Jameer Nelson,DEN , PG,1228,235,1466,2016-12-04,-993
Bismack Biyombo,ORL ," PF,C",773,675,1457,2016-12-04,-98
Reggie Jackson,DET ," PG,SG",62,1370,1445,2016-12-04,1308
Dario Saric,PHI ," SF,PF",318,1110,1433,2016-12-04,792
Kyle O'Quinn,NY ," PF,C",538,891,1430,2016-12-04,353
Tyler Johnson,MIA ," PG,SG",790,625,1421,2016-12-04,-165
Ersan Ilyasova,PHI ," SF,PF",930,406,1348,2016-12-04,-524
Ty Lawson,SAC , PG,868,445,1317,2016-12-04,-423
Joakim Noah,NY ," PF,C",861,412,1280,2016-12-04,-449
J.R. Smith,CLE ," SG,SF",974,275,1259,2016-12-04,-699
Troy Daniels,MEM ," PG,SG",260,15191,15451,2016-12-05,14931
Wayne Ellington,MIA ," SG,SF",767,5973,6744,2016-12-05,5206
C.J. Miles,IND ," SG,SF",665,5687,6352,2016-12-05,5022
Tyler Johnson,MIA ," SF,PF",5416,423,5846,2016-12-05,-4993
JaMychal Green,MEM , PF,283,5463,5754,2016-12-05,5180
Tim Frazier,NO ," PG,SG",5439,155,5614,2016-12-05,-5284
Will Barton,DEN ," SG,SF",253,5158,5419,2016-12-05,4905
Sergio Rodriguez,PHI , PG,234,5047,5284,2016-12-05,4813
Ish Smith,DET , PG,4592,545,5146,2016-12-05,-4047
Dario Saric,PHI ," SF,PF",269,4853,5128,2016-12-05,4584
John Henson,MIL ," PF,C",488,4216,4711,2016-12-05,3728
Andre Roberson,OKC ," SG,SF",1861,2643,4507,2016-12-05,782
Glenn Robinson III,IND ," SG,SF",4323,29,4354,2016-12-05,-4294
Patty Mills,SA , PG,809,3111,3925,2016-12-05,2302
Andrew Harrison,MEM ," PG,SG",3472,367,3851,2016-12-05,-3105
Matt Barnes,SAC ," SG,SF",3334,89,3424,2016-12-05,-3245
Frank Kaminsky,CHA ," PF,C",1356,1921,3285,2016-12-05,565
Dwight Powell,DAL ," PF,C",175,3096,3272,2016-12-05,2921
Jamal Murray,DEN , SG,2764,425,3197,2016-12-05,-2339
Lucas Nogueira,TOR ," PF,C",612,2478,3090,2016-12-05,1866
P.J. Tucker,PHO ," SG,SF",271,2519,2790,2016-12-05,2248
J.R. Smith,CLE ," SG,SF",2431,343,2785,2016-12-05,-2088
Deron Williams,DAL , PG,238,2473,2725,2016-12-05,2235
Robert Covington,PHI ," SF,PF",2596,119,2722,2016-12-05,-2477
Tony Allen,MEM ," SG,SF",138,2483,2622,2016-12-05,2345
Patrick Patterson,TOR ," PF,C",678,1935,2614,2016-12-05,1257
Jon Leuer,DET ," PF,C",838,1491,2335,2016-12-05,653
Ersan Ilyasova,PHI ," SF,PF",657,1632,2301,2016-12-05,975
Sam Dekker,HOU ," SF,PF",951,1337,2289,2016-12-05,386
Elfrid Payton,ORL , PG,2017,255,2287,2016-12-05,-1762
Tyler Johnson,MIA ," PG,SG",593,1625,2230,2016-12-05,1032
Emmanuel Mudiay,DEN , PG,1879,266,2157,2016-12-05,-1613
Jeff Green,ORL ," SG,SF",216,1936,2152,2016-12-05,1720
Tyson Chandler,PHO , C,1512,579,2102,2016-12-05,-933
Andrew Bogut,DAL , C,1529,520,2058,2016-12-05,-1009
Nick Young,LAL ," SG,SF",1825,220,2049,2016-12-05,-1605
Jameer Nelson,DEN , PG,1485,448,1936,2016-12-05,-1037
Terrence Jones,NO ," SF,PF",1657,254,1922,2016-12-05,-1403
Kent Bazemore,ATL ," SG,SF",1761,143,1918,2016-12-05,-1618
Cody Zeller,CHA ," PF,C",894,957,1857,2016-12-05,63
Brandon Ingram,LAL ," SG,SF",1140,620,1769,2016-12-05,-520
Evan Turner,POR ," SG,SF",560,1194,1760,2016-12-05,634
Larry Nance Jr.,LAL , PF,1575,160,1742,2016-12-05,-1415
Nikola Mirotic,CHI ," SF,PF",1266,463,1740,2016-12-05,-803
Jeremy Lamb,CHA ," SG,SF",1608,128,1736,2016-12-05,-1480
Alex Len,PHO ," PF,C",1302,402,1720,2016-12-05,-900
Maurice Harkless,POR , SF,275,1404,1695,2016-12-05,1129
Seth Curry,DAL ," PG,SG",1587,95,1686,2016-12-05,-1492
Nik Stauskas,PHI ," SG,SF",1385,295,1685,2016-12-05,-1090
Jamal Crawford,LAC ," SG,SF",1198,426,1639,2016-12-05,-772
Dwight Powell,DAL ," PF,C",207,11803,12010,2016-12-06,11596
Troy Daniels,MEM ," PG,SG",1565,4679,6245,2016-12-06,3114
Tyler Johnson,MIA ," SF,PF",4188,45,4235,2016-12-06,-4143
Wayne Ellington,MIA ," SG,SF",538,3695,4234,2016-12-06,3157
Andrew Harrison,MEM ," PG,SG",3984,201,4193,2016-12-06,-3783
Sergio Rodriguez,PHI , PG,1011,3063,4078,2016-12-06,2052
Andrew Bogut,DAL , C,3879,49,3929,2016-12-06,-3830
Ersan Ilyasova,PHI ," SF,PF",289,3570,3867,2016-12-06,3281
Dario Saric,PHI ," SF,PF",513,3082,3604,2016-12-06,2569
Will Barton,DEN ," SG,SF",115,3139,3269,2016-12-06,3024
J.R. Smith,CLE ," SG,SF",3105,104,3215,2016-12-06,-3001
Tony Allen,MEM ," SG,SF",419,2699,3118,2016-12-06,2280
Thabo Sefolosha,ATL ," SG,SF",181,2520,2705,2016-12-06,2339
Frank Kaminsky,CHA ," PF,C",1741,554,2302,2016-12-06,-1187
Deron Williams,DAL , PG,151,2102,2260,2016-12-06,1951
P.J. Tucker,PHO ," SG,SF",1160,1082,2243,2016-12-06,-78
John Henson,MIL ," PF,C",524,1697,2233,2016-12-06,1173
C.J. Miles,IND ," SG,SF",850,1304,2155,2016-12-06,454
Patty Mills,SA , PG,1222,874,2100,2016-12-06,-348
JaMychal Green,MEM , PF,646,1430,2081,2016-12-06,784
Andre Roberson,OKC ," SG,SF",1775,280,2058,2016-12-06,-1495
Jamal Murray,DEN , SG,449,1553,2009,2016-12-06,1104
Patrick Patterson,TOR ," PF,C",540,1404,1948,2016-12-06,864
Ish Smith,DET , PG,1450,459,1916,2016-12-06,-991
Elfrid Payton,ORL , PG,799,1089,1903,2016-12-06,290
Allen Crabbe,POR ," PG,SG",130,1749,1881,2016-12-06,1619
Emmanuel Mudiay,DEN , PG,1708,117,1839,2016-12-06,-1591
Jeff Green,ORL ," SG,SF",175,1599,1775,2016-12-06,1424
Tyson Chandler,PHO , C,1256,499,1765,2016-12-06,-757
Tim Frazier,NO ," PG,SG",1445,142,1601,2016-12-06,-1303
Jameer Nelson,DEN , PG,642,940,1583,2016-12-06,298
Cody Zeller,CHA ," PF,C",813,763,1583,2016-12-06,-50
Robert Covington,PHI ," SF,PF",1498,68,1569,2016-12-06,-1430
Kent Bazemore,ATL ," SG,SF",1441,108,1567,2016-12-06,-1333
Danny Green,SA ," SG,SF",1398,157,1563,2016-12-06,-1241
Jon Leuer,DET ," PF,C",769,712,1493,2016-12-06,-57
Tyler Johnson,MIA ," PG,SG",393,1065,1469,2016-12-06,672
Zach Randolph,MEM ," PF,C",383,1060,1450,2016-12-06,677
Bismack Biyombo,ORL ," PF,C",419,1018,1442,2016-12-06,599
Seth Curry,DAL ," PG,SG",1333,76,1414,2016-12-06,-1257
Sam Dekker,HOU ," SF,PF",1310,103,1414,2016-12-06,-1207
Brandon Ingram,LAL ," SG,SF",1152,249,1408,2016-12-06,-903
Josh Richardson,MIA ," SG,SF",1259,134,1400,2016-12-06,-1125
Terrence Jones,NO ," SF,PF",1214,151,1376,2016-12-06,-1063
Sean Kilpatrick,BKN ," PG,SG",230,1090,1335,2016-12-06,860
Brandon Jennings,NY , PG,362,970,1333,2016-12-06,608
Alex Len,PHO ," PF,C",928,384,1322,2016-12-06,-544
Evan Turner,POR ," SG,SF",527,786,1314,2016-12-06,259
Trey Lyles,UTA , PF,1067,239,1308,2016-12-06,-828
Marvin Williams,CHA ," SF,PF",569,735,1307,2016-12-06,166
Ersan Ilyasova,PHI ," SF,PF",147,6665,6826,2016-12-07,6518
Dwight Powell,DAL ," PF,C",614,4453,5068,2016-12-07,3839
Andrew Harrison,MEM ," PG,SG",3158,118,3282,2016-12-07,-3040
Marvin Williams,CHA ," SF,PF",409,2776,3187,2016-12-07,2367
Troy Daniels,MEM ," PG,SG",2325,705,3034,2016-12-07,-1620
Wayne Ellington,MIA ," SG,SF",736,2233,2973,2016-12-07,1497
Jeff Green,ORL ," SG,SF",735,2122,2857,2016-12-07,1387
Patrick Patterson,TOR ," PF,C",311,2541,2857,2016-12-07,2230
Ish Smith,DET , PG,2134,681,2827,2016-12-07,-1453
Andrew Bogut,DAL , C,2715,35,2753,2016-12-07,-2680
Frank Kaminsky,CHA ," PF,C",2306,235,2544,2016-12-07,-2071
Kent Bazemore,ATL ," SG,SF",2237,120,2377,2016-12-07,-2117
JaMychal Green,MEM , PF,295,2073,2377,2016-12-07,1778
Tony Allen,MEM ," SG,SF",546,1758,2305,2016-12-07,1212
Will Barton,DEN ," SG,SF",88,2196,2299,2016-12-07,2108
J.R. Smith,CLE ," SG,SF",2195,79,2285,2016-12-07,-2116
Dario Saric,PHI ," SF,PF",326,1916,2246,2016-12-07,1590
Tyler Johnson,MIA ," SF,PF",2193,24,2220,2016-12-07,-2169
P.J. Tucker,PHO ," SG,SF",2156,37,2197,2016-12-07,-2119
C.J. Miles,IND ," SG,SF",1387,724,2114,2016-12-07,-663
Patty Mills,SA , PG,360,1742,2107,2016-12-07,1382
Sergio Rodriguez,PHI , PG,1481,470,1957,2016-12-07,-1011
John Henson,MIL ," PF,C",1052,831,1894,2016-12-07,-221
Elfrid Payton,ORL , PG,233,1621,1874,2016-12-07,1388
Jon Leuer,DET ," PF,C",1593,276,1874,2016-12-07,-1317
Lucas Nogueira,TOR ," PF,C",294,1571,1867,2016-12-07,1277
Brandon Jennings,NY , PG,391,1458,1853,2016-12-07,1067
Terrence Ross,TOR ," SG,SF",136,1638,1778,2016-12-07,1502
Allen Crabbe,POR ," PG,SG",168,1606,1774,2016-12-07,1438
Jamal Murray,DEN , SG,489,1277,1769,2016-12-07,788
Jameer Nelson,DEN , PG,308,1372,1680,2016-12-07,1064
Emmanuel Mudiay,DEN , PG,1432,215,1674,2016-12-07,-1217
Zach Randolph,MEM ," PF,C",162,1501,1673,2016-12-07,1339
Bismack Biyombo,ORL ," PF,C",611,1009,1627,2016-12-07,398
Tyler Johnson,MIA ," PG,SG",331,1281,1625,2016-12-07,950
Tim Frazier,NO ," PG,SG",760,809,1588,2016-12-07,49
Tyson Chandler,PHO , C,1156,370,1532,2016-12-07,-786
Deron Williams,DAL , PG,181,1260,1450,2016-12-07,1079
Alex Len,PHO ," PF,C",1182,222,1421,2016-12-07,-960
Thabo Sefolosha,ATL ," SG,SF",354,1045,1403,2016-12-07,691
Kyle O'Quinn,NY ," PF,C",344,992,1336,2016-12-07,648
Rondae Hollis-Jefferson,BKN ," SG,SF",1133,199,1335,2016-12-07,-934
Cody Zeller,CHA ," PF,C",751,544,1296,2016-12-07,-207
Nick Young,LAL ," SG,SF",563,704,1271,2016-12-07,141
Nikola Mirotic,CHI ," SF,PF",709,526,1238,2016-12-07,-183
Danny Green,SA ," SG,SF",1076,144,1235,2016-12-07,-932
Monta Ellis,IND ," PG,SG",945,259,1220,2016-12-07,-686
Evan Turner,POR ," SG,SF",498,706,1209,2016-12-07,208
Patrick Beverley,HOU ," PG,SG",296,861,1167,2016-12-07,565
Terrence Jones,NO ," SF,PF",689,451,1150,2016-12-07,-238
Wayne Ellington,MIA ," SG,SF",384,6063,6453,2016-12-08,5679
Troy Daniels,MEM ," PG,SG",5269,349,5627,2016-12-08,-4920
Kyle O'Quinn,NY ," PF,C",230,4151,4382,2016-12-08,3921
Ersan Ilyasova,PHI ," SF,PF",306,3365,3688,2016-12-08,3059
Emmanuel Mudiay,DEN , PG,3100,165,3292,2016-12-08,-2935
Patrick Beverley,HOU ," PG,SG",160,3074,3247,2016-12-08,2914
Andrew Harrison,MEM ," PG,SG",3151,74,3235,2016-12-08,-3077
Jameer Nelson,DEN , PG,426,2724,3153,2016-12-08,2298
Tyler Johnson,MIA ," PG,SG",133,2932,3072,2016-12-08,2799
Marvin Williams,CHA ," SF,PF",287,2587,2878,2016-12-08,2300
Ish Smith,DET , PG,2402,330,2739,2016-12-08,-2072
Kenneth Faried,DEN ," PF,C",2440,129,2596,2016-12-08,-2311
Dwight Powell,DAL ," PF,C",548,1935,2486,2016-12-08,1387
C.J. Miles,IND ," SG,SF",1878,280,2170,2016-12-08,-1598
Frank Kaminsky,CHA ," PF,C",1933,162,2102,2016-12-08,-1771
Patrick Patterson,TOR ," PF,C",682,1387,2075,2016-12-08,705
Lucas Nogueira,TOR ," PF,C",261,1794,2056,2016-12-08,1533
Kent Bazemore,ATL ," SG,SF",1797,114,1931,2016-12-08,-1683
Tim Frazier,NO ," PG,SG",891,940,1849,2016-12-08,49
Nick Young,LAL ," SG,SF",314,1483,1804,2016-12-08,1169
Tyson Chandler,PHO , C,354,1409,1775,2016-12-08,1055
Brandon Jennings,NY , PG,346,1413,1763,2016-12-08,1067
Tony Allen,MEM ," SG,SF",581,1147,1728,2016-12-08,566
Deron Williams,DAL , PG,117,1587,1720,2016-12-08,1470
Jon Leuer,DET ," PF,C",1409,239,1660,2016-12-08,-1170
JaMychal Green,MEM , PF,376,1260,1648,2016-12-08,884
Maurice Harkless,POR , SF,1294,325,1634,2016-12-08,-969
Patty Mills,SA , PG,561,1054,1624,2016-12-08,493
Jamal Murray,DEN , SG,937,684,1624,2016-12-08,-253
Terrence Jones,NO ," SF,PF",1271,322,1602,2016-12-08,-949
Dario Saric,PHI ," SF,PF",623,927,1558,2016-12-08,304
John Henson,MIL ," PF,C",812,729,1556,2016-12-08,-83
Allen Crabbe,POR ," PG,SG",707,811,1519,2016-12-08,104
Alex Len,PHO ," PF,C",1318,180,1512,2016-12-08,-1138
Andrew Bogut,DAL , C,1456,22,1489,2016-12-08,-1434
Courtney Lee,NY ," SG,SF",185,1280,1468,2016-12-08,1095
Thabo Sefolosha,ATL ," SG,SF",257,1106,1365,2016-12-08,849
Rondae Hollis-Jefferson,BKN ," SG,SF",1292,67,1362,2016-12-08,-1225
Will Barton,DEN ," SG,SF",305,1034,1361,2016-12-08,729
Robert Covington,PHI ," SF,PF",501,840,1350,2016-12-08,339
Elfrid Payton,ORL , PG,366,959,1340,2016-12-08,593
Monta Ellis,IND ," PG,SG",1059,247,1328,2016-12-08,-812
Marco Belinelli,CHA ," SG,SF",182,1130,1315,2016-12-08,948
Sergio Rodriguez,PHI , PG,840,460,1307,2016-12-08,-380
J.R. Smith,CLE ," SG,SF",1133,113,1257,2016-12-08,-1020
Evan Turner,POR ," SG,SF",837,412,1254,2016-12-08,-425
Zach Randolph,MEM ," PF,C",272,960,1247,2016-12-08,688
Cody Zeller,CHA ," PF,C",680,553,1246,2016-12-08,-127
Marcus Smart,BOS , PG,344,880,1236,2016-12-08,536
Sam Dekker,HOU ," SF,PF",159,995,1155,2016-12-08,836
Troy Daniels,MEM ," PG,SG",4758,149,4916,2016-12-09,-4609
Tony Allen,MEM ," SG,SF",303,4088,4393,2016-12-09,3785
Wayne Ellington,MIA ," SG,SF",676,3471,4153,2016-12-09,2795
Ersan Ilyasova,PHI ," SF,PF",176,3051,3237,2016-12-09,2875
Kyle O'Quinn,NY ," PF,C",311,2486,2798,2016-12-09,2175
Andrew Harrison,MEM ," PG,SG",2742,38,2793,2016-12-09,-2704
Shelvin Mack,UTA , PG,131,2606,2737,2016-12-09,2475
Jameer Nelson,DEN , PG,394,2116,2514,2016-12-09,1722
Langston Galloway,NO ," PG,SG",169,2264,2434,2016-12-09,2095
Kenneth Faried,DEN ," PF,C",2239,98,2349,2016-12-09,-2141
Emmanuel Mudiay,DEN , PG,2233,95,2349,2016-12-09,-2138
Patrick Beverley,HOU ," PG,SG",135,1886,2031,2016-12-09,1751
Lucas Nogueira,TOR ," PF,C",853,1175,2031,2016-12-09,322
Patrick Patterson,TOR ," PF,C",1758,201,1967,2016-12-09,-1557
Tyler Johnson,MIA ," PG,SG",106,1720,1836,2016-12-09,1614
JaMychal Green,MEM , PF,211,1580,1805,2016-12-09,1369
Dwight Powell,DAL ," PF,C",645,1085,1735,2016-12-09,440
Patty Mills,SA , PG,380,1261,1655,2016-12-09,881
Sergio Rodriguez,PHI , PG,327,1281,1619,2016-12-09,954
Ish Smith,DET , PG,1315,223,1547,2016-12-09,-1092
Marvin Williams,CHA ," SF,PF",431,1063,1501,2016-12-09,632
Tim Frazier,NO ," PG,SG",855,599,1461,2016-12-09,-256
Tyson Chandler,PHO , C,401,1040,1455,2016-12-09,639
C.J. Miles,IND ," SG,SF",671,760,1436,2016-12-09,89
Terrence Jones,NO ," SF,PF",1212,158,1382,2016-12-09,-1054
Monta Ellis,IND ," PG,SG",1079,267,1370,2016-12-09,-812
Maurice Harkless,POR , SF,1115,150,1286,2016-12-09,-965
Deron Williams,DAL , PG,73,1190,1275,2016-12-09,1117
Terrence Ross,TOR ," SG,SF",963,291,1262,2016-12-09,-672
Kent Bazemore,ATL ," SG,SF",1115,121,1251,2016-12-09,-994
John Henson,MIL ," PF,C",640,575,1224,2016-12-09,-65
Dario Saric,PHI ," SF,PF",463,667,1137,2016-12-09,204
Channing Frye,CLE ," PF,C",1045,83,1132,2016-12-09,-962
Brandon Jennings,NY , PG,370,757,1130,2016-12-09,387
Nick Young,LAL ," SG,SF",259,833,1103,2016-12-09,574
Marco Belinelli,CHA ," SG,SF",236,856,1092,2016-12-09,620
Jamal Crawford,LAC ," SG,SF",160,899,1063,2016-12-09,739
Jamal Murray,DEN , SG,952,103,1060,2016-12-09,-849
Courtney Lee,NY ," SG,SF",303,753,1060,2016-12-09,450
Cody Zeller,CHA ," PF,C",321,708,1042,2016-12-09,387
Alex Len,PHO ," PF,C",641,375,1029,2016-12-09,-266
Andrew Bogut,DAL , C,970,48,1024,2016-12-09,-922
Frank Kaminsky,CHA ," PF,C",789,232,1022,2016-12-09,-557
Sam Dekker,HOU ," SF,PF",283,713,997,2016-12-09,430
J.R. Smith,CLE ," SG,SF",818,170,990,2016-12-09,-648
Marcus Smart,BOS , PG,272,702,986,2016-12-09,430
Jon Leuer,DET ," PF,C",712,246,969,2016-12-09,-466
Thabo Sefolosha,ATL ," SG,SF",433,528,965,2016-12-09,95
Matt Barnes,SAC ," SG,SF",859,102,963,2016-12-09,-757
Brandon Ingram,LAL ," SG,SF",520,416,945,2016-12-09,-104
Langston Galloway,NO ," PG,SG",278,5691,5969,2016-12-10,5413
Kyle O'Quinn,NY ," PF,C",288,4431,4721,2016-12-10,4143
Troy Daniels,MEM ," PG,SG",4477,90,4573,2016-12-10,-4387
Wayne Ellington,MIA ," SG,SF",4029,353,4385,2016-12-10,-3676
Sergio Rodriguez,PHI , PG,152,3775,3935,2016-12-10,3623
Andre Roberson,OKC ," SG,SF",196,2904,3102,2016-12-10,2708
Ersan Ilyasova,PHI ," SF,PF",84,2665,2765,2016-12-10,2581
Tony Allen,MEM ," SG,SF",715,1723,2439,2016-12-10,1008
Alex Len,PHO ," PF,C",157,2139,2305,2016-12-10,1982
T.J. Warren,PHO , SF,198,2024,2233,2016-12-10,1826
C.J. Miles,IND ," SG,SF",864,1337,2206,2016-12-10,473
Ish Smith,DET , PG,1708,427,2140,2016-12-10,-1281
Jameer Nelson,DEN , PG,1463,574,2041,2016-12-10,-889
Monta Ellis,IND ," PG,SG",1825,189,2035,2016-12-10,-1636
Brandon Jennings,NY , PG,497,1454,1952,2016-12-10,957
Dario Saric,PHI ," SF,PF",245,1677,1931,2016-12-10,1432
Dwight Powell,DAL ," PF,C",1145,717,1868,2016-12-10,-428
Nerlens Noel,PHI ," PF,C",171,1689,1863,2016-12-10,1518
Tim Frazier,NO ," PG,SG",452,1387,1855,2016-12-10,935
Shelvin Mack,UTA , PG,899,867,1766,2016-12-10,-32
Patrick Patterson,TOR ," PF,C",1560,123,1689,2016-12-10,-1437
Marcus Smart,BOS , PG,262,1399,1673,2016-12-10,1137
Andrew Harrison,MEM ," PG,SG",1609,42,1658,2016-12-10,-1567
Nick Young,LAL ," SG,SF",243,1396,1646,2016-12-10,1153
John Henson,MIL ," PF,C",1107,439,1559,2016-12-10,-668
Emmanuel Mudiay,DEN , PG,1363,167,1550,2016-12-10,-1196
Tyson Chandler,PHO , C,448,1080,1536,2016-12-10,632
Jon Leuer,DET ," PF,C",311,1204,1522,2016-12-10,893
Marvin Williams,CHA ," SF,PF",1222,224,1454,2016-12-10,-998
Patrick Beverley,HOU ," PG,SG",416,996,1422,2016-12-10,580
Courtney Lee,NY ," SG,SF",368,1031,1405,2016-12-10,663
Larry Nance Jr.,LAL , PF,259,1138,1401,2016-12-10,879
Robert Covington,PHI ," SF,PF",249,1133,1390,2016-12-10,884
Tyler Johnson,MIA ," PG,SG",602,762,1372,2016-12-10,160
JaMychal Green,MEM , PF,278,1073,1364,2016-12-10,795
Lucas Nogueira,TOR ," PF,C",1085,272,1358,2016-12-10,-813
Terry Rozier,BOS , PG,62,1249,1311,2016-12-10,1187
Patty Mills,SA , PG,523,732,1267,2016-12-10,209
Matt Barnes,SAC ," SG,SF",1227,20,1248,2016-12-10,-1207
Jamal Murray,DEN , SG,1102,78,1185,2016-12-10,-1024
Brandon Ingram,LAL ," SG,SF",552,601,1162,2016-12-10,49
Frank Kaminsky,CHA ," PF,C",1013,140,1158,2016-12-10,-873
Sean Kilpatrick,BKN ," PG,SG",560,586,1157,2016-12-10,26
Deron Williams,DAL , PG,353,786,1152,2016-12-10,433
Bismack Biyombo,ORL ," PF,C",974,113,1099,2016-12-10,-861
Kenneth Faried,DEN ," PF,C",810,261,1099,2016-12-10,-549
J.R. Smith,CLE ," SG,SF",705,368,1080,2016-12-10,-337
Jahlil Okafor,PHI , C,261,804,1078,2016-12-10,543
Cody Zeller,CHA ," PF,C",697,362,1064,2016-12-10,-335
Lou Williams,LAL ," PG,SG",33,970,1033,2016-12-10,937
Kelly Oubre Jr.,WAS , SF,101,5572,5673,2016-12-11,5471
Troy Daniels,MEM ," PG,SG",4888,73,4965,2016-12-11,-4815
Wayne Ellington,MIA ," SG,SF",4263,186,4455,2016-12-11,-4077
Kyle O'Quinn,NY ," PF,C",2302,1727,4031,2016-12-11,-575
Sergio Rodriguez,PHI , PG,1879,1769,3653,2016-12-11,-110
Nick Young,LAL ," SG,SF",247,3266,3518,2016-12-11,3019
Josh Richardson,MIA ," SG,SF",214,3258,3473,2016-12-11,3044
Langston Galloway,NO ," PG,SG",2173,921,3094,2016-12-11,-1252
Tony Allen,MEM ," SG,SF",576,2324,2904,2016-12-11,1748
Tim Frazier,NO ," PG,SG",536,2206,2752,2016-12-11,1670
Ish Smith,DET , PG,2424,318,2752,2016-12-11,-2106
Andre Roberson,OKC ," SG,SF",1023,1470,2496,2016-12-11,447
Dario Saric,PHI ," SF,PF",1563,744,2313,2016-12-11,-819
Jon Leuer,DET ," PF,C",1577,638,2223,2016-12-11,-939
Alex Len,PHO ," PF,C",729,1293,2038,2016-12-11,564
Ersan Ilyasova,PHI ," SF,PF",266,1728,2009,2016-12-11,1462
Jameer Nelson,DEN , PG,1769,216,1988,2016-12-11,-1553
Monta Ellis,IND ," PG,SG",1804,135,1963,2016-12-11,-1669
Dwight Powell,DAL ," PF,C",934,990,1926,2016-12-11,56
Patrick Beverley,HOU ," PG,SG",342,1566,1920,2016-12-11,1224
Nerlens Noel,PHI ," PF,C",481,1425,1920,2016-12-11,944
C.J. Miles,IND ," SG,SF",1271,591,1867,2016-12-11,-680
Emmanuel Mudiay,DEN , PG,1566,271,1851,2016-12-11,-1295
Tyler Johnson,MIA ," PG,SG",503,1226,1736,2016-12-11,723
Brandon Ingram,LAL ," SG,SF",1248,469,1729,2016-12-11,-779
Brandon Jennings,NY , PG,876,839,1718,2016-12-11,-37
Patty Mills,SA , PG,476,1171,1656,2016-12-11,695
Tyson Chandler,PHO , C,434,1169,1612,2016-12-11,735
Jamal Crawford,LAC ," SG,SF",304,1212,1521,2016-12-11,908
Omri Casspi,SAC ," SF,PF",63,1436,1499,2016-12-11,1373
John Henson,MIL ," PF,C",746,695,1454,2016-12-11,-51
Robert Covington,PHI ," SF,PF",345,1079,1432,2016-12-11,734
Marcus Smart,BOS , PG,406,999,1408,2016-12-11,593
Andrew Harrison,MEM ," PG,SG",1299,97,1399,2016-12-11,-1202
Evan Turner,POR ," SG,SF",1083,309,1397,2016-12-11,-774
Patrick Patterson,TOR ," PF,C",1020,362,1392,2016-12-11,-658
Larry Nance Jr.,LAL , PF,503,853,1360,2016-12-11,350
JaMychal Green,MEM , PF,216,1100,1326,2016-12-11,884
Jahlil Okafor,PHI , C,317,992,1320,2016-12-11,675
Jamal Murray,DEN , SG,1233,72,1308,2016-12-11,-1161
Kenneth Faried,DEN ," PF,C",295,980,1304,2016-12-11,685
Cody Zeller,CHA ," PF,C",412,879,1302,2016-12-11,467
Frank Kaminsky,CHA ," PF,C",1112,150,1264,2016-12-11,-962
Marvin Williams,CHA ," SF,PF",959,279,1249,2016-12-11,-680
Terrence Jones,NO ," SF,PF",867,374,1248,2016-12-11,-493
T.J. McConnell,PHI , PG,100,1131,1231,2016-12-11,1031
Courtney Lee,NY ," SG,SF",593,628,1224,2016-12-11,35
Maurice Harkless,POR , SF,702,504,1219,2016-12-11,-198
Sean Kilpatrick,BKN ," PG,SG",857,309,1182,2016-12-11,-548
Lucas Nogueira,TOR ," PF,C",585,582,1171,2016-12-11,-3
Tony Allen,MEM ," SG,SF",325,6645,6970,2016-12-12,6320
Nick Young,LAL ," SG,SF",567,5869,6440,2016-12-12,5302
Tim Frazier,NO ," PG,SG",306,5729,6043,2016-12-12,5423
Kelly Oubre Jr.,WAS , SF,1260,3218,4478,2016-12-12,1958
Troy Daniels,MEM ," PG,SG",4243,156,4403,2016-12-12,-4087
Monta Ellis,IND ," PG,SG",3999,193,4207,2016-12-12,-3806
Wayne Ellington,MIA ," SG,SF",3695,222,3922,2016-12-12,-3473
Tyson Chandler,PHO , C,258,3651,3916,2016-12-12,3393
Sergio Rodriguez,PHI , PG,3320,251,3581,2016-12-12,-3069
Kyle O'Quinn,NY ," PF,C",3144,177,3321,2016-12-12,-2967
Ish Smith,DET , PG,3212,96,3315,2016-12-12,-3116
Jameer Nelson,DEN , PG,2794,160,2958,2016-12-12,-2634
Dorian Finney-Smith,DAL ," SF,PF",42,2877,2919,2016-12-12,2835
Dwight Powell,DAL ," PF,C",2001,893,2899,2016-12-12,-1108
Josh Richardson,MIA ," SG,SF",469,2425,2898,2016-12-12,1956
Brandon Ingram,LAL ," SG,SF",2745,99,2849,2016-12-12,-2646
Jon Leuer,DET ," PF,C",2585,188,2786,2016-12-12,-2397
Dario Saric,PHI ," SF,PF",2626,99,2732,2016-12-12,-2527
Langston Galloway,NO ," PG,SG",2487,231,2719,2016-12-12,-2256
Thabo Sefolosha,ATL ," SG,SF",347,2299,2650,2016-12-12,1952
JaMychal Green,MEM , PF,186,2323,2517,2016-12-12,2137
Andre Roberson,OKC ," SG,SF",1464,851,2316,2016-12-12,-613
Patrick Beverley,HOU ," PG,SG",323,1925,2260,2016-12-12,1602
T.J. Warren,PHO , SF,206,2031,2246,2016-12-12,1825
Brandon Jennings,NY , PG,675,1554,2231,2016-12-12,879
Omri Casspi,SAC ," SF,PF",233,1960,2193,2016-12-12,1727
Leandro Barbosa,PHO ," PG,SG",106,2036,2142,2016-12-12,1930
Courtney Lee,NY ," SG,SF",448,1661,2112,2016-12-12,1213
Patrick Patterson,TOR ," PF,C",1653,430,2088,2016-12-12,-1223
Kenneth Faried,DEN ," PF,C",903,1125,2048,2016-12-12,222
Jeremy Lin,BKN ," PG,SG",148,1863,2024,2016-12-12,1715
Emmanuel Mudiay,DEN , PG,1464,504,1987,2016-12-12,-960
C.J. Miles,IND ," SG,SF",1416,519,1937,2016-12-12,-897
Patty Mills,SA , PG,507,1364,1880,2016-12-12,857
John Henson,MIL ," PF,C",1315,527,1859,2016-12-12,-788
Will Barton,DEN ," SG,SF",1381,449,1843,2016-12-12,-932
Alex Len,PHO ," PF,C",1366,440,1814,2016-12-12,-926
Ersan Ilyasova,PHI ," SF,PF",504,1292,1813,2016-12-12,788
Tyler Johnson,MIA ," SF,PF",342,1433,1777,2016-12-12,1091
Frank Kaminsky,CHA ," PF,C",1546,220,1769,2016-12-12,-1326
Andrew Harrison,MEM ," PG,SG",1252,463,1718,2016-12-12,-789
Sean Kilpatrick,BKN ," PG,SG",1388,313,1716,2016-12-12,-1075
Maurice Harkless,POR , SF,885,805,1703,2016-12-12,-80
Robert Covington,PHI ," SF,PF",462,1218,1685,2016-12-12,756
Tyler Johnson,MIA ," PG,SG",637,1022,1668,2016-12-12,385
Jamal Crawford,LAC ," SG,SF",404,1238,1649,2016-12-12,834
Terrence Jones,NO ," SF,PF",1255,356,1622,2016-12-12,-899
Larry Nance Jr.,LAL , PF,1355,256,1611,2016-12-12,-1099
Ed Davis,POR ," PF,C",233,1350,1584,2016-12-12,1117
Marcus Smart,BOS , PG,619,945,1571,2016-12-12,326
Dorian Finney-Smith,DAL ," SF,PF",212,15123,15335,2016-12-13,14911
Tyler Johnson,MIA ," SF,PF",214,4809,5023,2016-12-13,4595
Troy Daniels,MEM ," PG,SG",3254,155,3414,2016-12-13,-3099
Tony Allen,MEM ," SG,SF",942,2261,3205,2016-12-13,1319
Dwight Powell,DAL ," PF,C",2919,274,3199,2016-12-13,-2645
J.R. Smith,CLE ," SG,SF",412,2597,3012,2016-12-13,2185
Kyle O'Quinn,NY ," PF,C",913,1791,2705,2016-12-13,878
Jameer Nelson,DEN , PG,2655,30,2687,2016-12-13,-2625
Monta Ellis,IND ," PG,SG",2331,200,2552,2016-12-13,-2131
Tyson Chandler,PHO , C,305,2181,2490,2016-12-13,1876
Omri Casspi,SAC ," SF,PF",230,2238,2468,2016-12-13,2008
Luol Deng,LAL ," SF,PF",299,2000,2301,2016-12-13,1701
Brandon Jennings,NY , PG,1065,1231,2297,2016-12-13,166
John Henson,MIL ," PF,C",1909,294,2209,2016-12-13,-1615
Will Barton,DEN ," SG,SF",1985,190,2188,2016-12-13,-1795
Wayne Ellington,MIA ," SG,SF",1375,606,1986,2016-12-13,-769
Patrick Beverley,HOU ," PG,SG",223,1735,1968,2016-12-13,1512
Patrick Patterson,TOR ," PF,C",1774,187,1962,2016-12-13,-1587
Thabo Sefolosha,ATL ," SG,SF",633,1322,1957,2016-12-13,689
Nick Young,LAL ," SG,SF",1137,692,1834,2016-12-13,-445
JaMychal Green,MEM , PF,586,1233,1827,2016-12-13,647
Tim Frazier,NO ," PG,SG",344,1468,1814,2016-12-13,1124
Alex Len,PHO ," PF,C",1550,206,1763,2016-12-13,-1344
Kelly Oubre Jr.,WAS , SF,1569,123,1693,2016-12-13,-1446
Maurice Harkless,POR , SF,1337,334,1680,2016-12-13,-1003
Patty Mills,SA , PG,232,1433,1669,2016-12-13,1201
Ish Smith,DET , PG,1474,117,1592,2016-12-13,-1357
Sean Kilpatrick,BKN ," PG,SG",1327,240,1579,2016-12-13,-1087
Kenneth Faried,DEN ," PF,C",1305,250,1569,2016-12-13,-1055
Brandon Ingram,LAL ," SG,SF",1496,69,1569,2016-12-13,-1427
Elfrid Payton,ORL , PG,348,1187,1550,2016-12-13,839
Jon Leuer,DET ," PF,C",1289,172,1467,2016-12-13,-1117
C.J. Miles,IND ," SG,SF",1001,435,1440,2016-12-13,-566
Leandro Barbosa,PHO ," PG,SG",623,775,1398,2016-12-13,152
Sergio Rodriguez,PHI , PG,1131,237,1373,2016-12-13,-894
Courtney Lee,NY ," SG,SF",599,749,1352,2016-12-13,150
Larry Nance Jr.,LAL , PF,1270,74,1347,2016-12-13,-1196
Derrick Favors,UTA ," PF,C",108,1217,1338,2016-12-13,1109
Tyler Johnson,MIA ," PG,SG",540,757,1306,2016-12-13,217
Langston Galloway,NO ," PG,SG",902,391,1295,2016-12-13,-511
Kent Bazemore,ATL ," SG,SF",1013,265,1287,2016-12-13,-748
Cody Zeller,CHA ," PF,C",538,740,1284,2016-12-13,202
Lucas Nogueira,TOR ," PF,C",820,456,1278,2016-12-13,-364
Frank Kaminsky,CHA ," PF,C",1153,95,1252,2016-12-13,-1058
Terrence Jones,NO ," SF,PF",946,296,1248,2016-12-13,-650
Nikola Mirotic,CHI ," SF,PF",907,331,1247,2016-12-13,-576
Jeremy Lin,BKN ," PG,SG",73,1166,1246,2016-12-13,1093
Andre Roberson,OKC ," SG,SF",729,508,1240,2016-12-13,-221
Dario Saric,PHI ," SF,PF",1153,77,1237,2016-12-13,-1076
Al-Farouq Aminu,POR ," SF,PF",580,640,1225,2016-12-13,60
Kyle O'Quinn,NY ," PF,C",170,10192,10368,2016-12-14,10022
Dorian Finney-Smith,DAL ," SF,PF",1183,3616,4799,2016-12-14,2433
Langston Galloway,NO ," PG,SG",231,4030,4263,2016-12-14,3799
Tyson Chandler,PHO , C,156,3833,4005,2016-12-14,3677
J.R. Smith,CLE ," SG,SF",712,2197,2916,2016-12-14,1485
JaMychal Green,MEM , PF,2085,236,2332,2016-12-14,-1849
Brandon Jennings,NY , PG,768,1506,2276,2016-12-14,738
Dwight Powell,DAL ," PF,C",2072,201,2274,2016-12-14,-1871
Troy Daniels,MEM ," PG,SG",2095,66,2163,2016-12-14,-2029
Tony Allen,MEM ," SG,SF",1637,422,2063,2016-12-14,-1215
Dario Saric,PHI ," SF,PF",1918,108,2034,2016-12-14,-1810
Alex Len,PHO ," PF,C",1931,74,2010,2016-12-14,-1857
Tim Frazier,NO ," PG,SG",964,941,1914,2016-12-14,-23
Wayne Ellington,MIA ," SG,SF",1432,475,1910,2016-12-14,-957
Patty Mills,SA , PG,278,1530,1815,2016-12-14,1252
Elfrid Payton,ORL , PG,156,1614,1783,2016-12-14,1458
Tyler Johnson,MIA ," SF,PF",399,1313,1713,2016-12-14,914
Andre Roberson,OKC ," SG,SF",1548,135,1684,2016-12-14,-1413
John Henson,MIL ," PF,C",1287,381,1676,2016-12-14,-906
Robert Covington,PHI ," SF,PF",207,1439,1650,2016-12-14,1232
Courtney Lee,NY ," SG,SF",394,1246,1646,2016-12-14,852
Aaron Gordon,ORL ," SF,PF",715,850,1577,2016-12-14,135
Thabo Sefolosha,ATL ," SG,SF",387,1179,1569,2016-12-14,792
Andrew Harrison,MEM ," PG,SG",1421,129,1551,2016-12-14,-1292
Monta Ellis,IND ," PG,SG",1328,201,1541,2016-12-14,-1127
Marvin Williams,CHA ," SF,PF",1218,297,1522,2016-12-14,-921
Will Barton,DEN ," SG,SF",1146,356,1512,2016-12-14,-790
J.J. Barea,DAL ," PG,SG",100,1369,1469,2016-12-14,1269
Ish Smith,DET , PG,1310,138,1451,2016-12-14,-1172
Evan Turner,POR ," SG,SF",429,1001,1436,2016-12-14,572
C.J. Miles,IND ," SG,SF",528,904,1436,2016-12-14,376
Gary Harris,DEN ," SG,SF",129,1283,1414,2016-12-14,1154
Omri Casspi,SAC ," SF,PF",455,948,1403,2016-12-14,493
Patrick Patterson,TOR ," PF,C",1237,104,1346,2016-12-14,-1133
Jon Leuer,DET ," PF,C",1033,298,1339,2016-12-14,-735
Kent Bazemore,ATL ," SG,SF",1119,161,1289,2016-12-14,-958
Lucas Nogueira,TOR ," PF,C",1093,173,1269,2016-12-14,-920
Luol Deng,LAL ," SF,PF",307,960,1267,2016-12-14,653
Terrence Jones,NO ," SF,PF",749,506,1265,2016-12-14,-243
P.J. Tucker,PHO ," SG,SF",174,1085,1259,2016-12-14,911
Emmanuel Mudiay,DEN , PG,521,711,1242,2016-12-14,190
Maurice Harkless,POR , SF,368,836,1219,2016-12-14,468
Sergio Rodriguez,PHI , PG,657,547,1211,2016-12-14,-110
Ersan Ilyasova,PHI ," SF,PF",639,496,1146,2016-12-14,-143
Nikola Mirotic,CHI ," SF,PF",899,218,1122,2016-12-14,-681
Nick Young,LAL ," SG,SF",674,423,1107,2016-12-14,-251
Jamal Crawford,LAC ," SG,SF",809,290,1105,2016-12-14,-519
Sean Kilpatrick,BKN ," PG,SG",727,316,1065,2016-12-14,-411
Justise Winslow,MIA ," SF,PF",406,648,1059,2016-12-14,242
Patrick Beverley,HOU ," PG,SG",195,857,1058,2016-12-14,662
Kyle O'Quinn,NY ," PF,C",1144,5897,7046,2016-12-15,4753
Gary Harris,DEN ," SG,SF",115,6317,6433,2016-12-15,6202
Langston Galloway,NO ," PG,SG",949,3781,4732,2016-12-15,2832
Tim Frazier,NO ," PG,SG",4071,193,4283,2016-12-15,-3878
Robert Covington,PHI ," SF,PF",114,3252,3374,2016-12-15,3138
Tyreke Evans,NO ," PG,SG,SF",234,2657,2899,2016-12-15,2423
Will Barton,DEN ," SG,SF",2243,376,2638,2016-12-15,-1867
Dario Saric,PHI ," SF,PF",2518,52,2577,2016-12-15,-2466
JaMychal Green,MEM , PF,2303,149,2462,2016-12-15,-2154
Jusuf Nurkic,DEN , C,2134,161,2316,2016-12-15,-1973
Patty Mills,SA , PG,1516,650,2185,2016-12-15,-866
Tyson Chandler,PHO , C,471,1675,2164,2016-12-15,1204
Sergio Rodriguez,PHI , PG,435,1714,2162,2016-12-15,1279
Dorian Finney-Smith,DAL ," SF,PF",1592,552,2144,2016-12-15,-1040
Thabo Sefolosha,ATL ," SG,SF",253,1861,2116,2016-12-15,1608
Austin Rivers,LAC ," PG,SG,SF",65,2003,2068,2016-12-15,1938
J.J. Barea,DAL ," PG,SG",167,1859,2028,2016-12-15,1692
Andrew Harrison,MEM ," PG,SG",1953,27,1980,2016-12-15,-1926
C.J. Miles,IND ," SG,SF",1265,705,1977,2016-12-15,-560
Tony Allen,MEM ," SG,SF",574,1292,1870,2016-12-15,718
Joe Ingles,UTA ," SG,SF",155,1710,1865,2016-12-15,1555
Brandon Jennings,NY , PG,715,986,1708,2016-12-15,271
Wayne Ellington,MIA ," SG,SF",1448,244,1697,2016-12-15,-1204
Marvin Williams,CHA ," SF,PF",1521,168,1694,2016-12-15,-1353
Kelly Oubre Jr.,WAS , SF,217,1411,1629,2016-12-15,1194
Luol Deng,LAL ," SF,PF",271,1352,1625,2016-12-15,1081
Dwight Powell,DAL ," PF,C",1182,387,1573,2016-12-15,-795
Alex Len,PHO ," PF,C",1492,70,1571,2016-12-15,-1422
John Henson,MIL ," PF,C",1050,506,1566,2016-12-15,-544
Andre Roberson,OKC ," SG,SF",1481,72,1557,2016-12-15,-1409
J.R. Smith,CLE ," SG,SF",1224,321,1550,2016-12-15,-903
Marquese Chriss,PHO , PF,169,1379,1549,2016-12-15,1210
Jon Leuer,DET ," PF,C",287,1179,1471,2016-12-15,892
Aaron Gordon,ORL ," SF,PF",170,1227,1414,2016-12-15,1057
Courtney Lee,NY ," SG,SF",704,686,1396,2016-12-15,-18
Nick Young,LAL ," SG,SF",627,740,1380,2016-12-15,113
Cody Zeller,CHA ," PF,C",270,1095,1376,2016-12-15,825
Maurice Harkless,POR , SF,718,599,1329,2016-12-15,-119
Ersan Ilyasova,PHI ," SF,PF",980,308,1319,2016-12-15,-672
Monta Ellis,IND ," PG,SG",980,312,1303,2016-12-15,-668
Tyler Johnson,MIA ," PG,SG",278,1008,1300,2016-12-15,730
P.J. Tucker,PHO ," SG,SF",648,644,1292,2016-12-15,-4
Danny Green,SA ," SG,SF",1160,94,1260,2016-12-15,-1066
Emmanuel Mudiay,DEN , PG,586,633,1231,2016-12-15,47
Justise Winslow,MIA ," SF,PF",418,799,1223,2016-12-15,381
Ish Smith,DET , PG,1059,149,1212,2016-12-15,-910
Patrick Beverley,HOU ," PG,SG",227,971,1212,2016-12-15,744
Patrick Patterson,TOR ," PF,C",963,200,1168,2016-12-15,-763
Evan Turner,POR ," SG,SF",602,547,1150,2016-12-15,-55
Elfrid Payton,ORL , PG,284,835,1133,2016-12-15,551
Gary Harris,DEN ," SG,SF",98,8268,8368,2016-12-16,8170
Kyle O'Quinn,NY ," PF,C",2285,1163,3450,2016-12-16,-1122
Jusuf Nurkic,DEN , C,3346,54,3416,2016-12-16,-3292
Kelly Oubre Jr.,WAS , SF,504,2518,3023,2016-12-16,2014
Langston Galloway,NO ," PG,SG",2790,210,3001,2016-12-16,-2580
Marquese Chriss,PHO , PF,252,2672,2925,2016-12-16,2420
Will Barton,DEN ," SG,SF",2411,335,2761,2016-12-16,-2076
Dorian Finney-Smith,DAL ," SF,PF",2139,314,2454,2016-12-16,-1825
Thabo Sefolosha,ATL ," SG,SF",314,1913,2229,2016-12-16,1599
Tim Frazier,NO ," PG,SG",2028,170,2221,2016-12-16,-1858
Jon Leuer,DET ," PF,C",209,1936,2152,2016-12-16,1727
Patty Mills,SA , PG,1930,168,2111,2016-12-16,-1762
JaMychal Green,MEM , PF,1905,144,2060,2016-12-16,-1761
Nikola Mirotic,CHI ," SF,PF",1931,82,2025,2016-12-16,-1849
Sergio Rodriguez,PHI , PG,1065,929,2001,2016-12-16,-136
John Henson,MIL ," PF,C",1694,225,1937,2016-12-16,-1469
Andrew Harrison,MEM ," PG,SG",1797,20,1819,2016-12-16,-1777
C.J. Miles,IND ," SG,SF",1268,425,1700,2016-12-16,-843
Robert Covington,PHI ," SF,PF",375,1284,1669,2016-12-16,909
Alex Len,PHO ," PF,C",1467,78,1556,2016-12-16,-1389
Dario Saric,PHI ," SF,PF",1505,25,1536,2016-12-16,-1480
Wayne Ellington,MIA ," SG,SF",1382,146,1530,2016-12-16,-1236
Nick Young,LAL ," SG,SF",477,1035,1523,2016-12-16,558
Luol Deng,LAL ," SF,PF",296,1226,1523,2016-12-16,930
Brandon Jennings,NY , PG,751,765,1518,2016-12-16,14
Tony Allen,MEM ," SG,SF",581,919,1512,2016-12-16,338
Tyson Chandler,PHO , C,679,753,1449,2016-12-16,74
Maurice Harkless,POR , SF,850,554,1421,2016-12-16,-296
Dwight Powell,DAL ," PF,C",1150,243,1396,2016-12-16,-907
Marco Belinelli,CHA ," SG,SF",166,1155,1321,2016-12-16,989
Tyreke Evans,NO ," PG,SG,SF",501,790,1298,2016-12-16,289
Patrick Beverley,HOU ," PG,SG",152,1126,1293,2016-12-16,974
Garrett Temple,SAC ," PG,SG",58,1230,1288,2016-12-16,1172
Terrence Jones,NO ," SF,PF",423,856,1287,2016-12-16,433
Cody Zeller,CHA ," PF,C",220,1051,1278,2016-12-16,831
Austin Rivers,LAC ," PG,SG,SF",441,821,1262,2016-12-16,380
Tyler Johnson,MIA ," PG,SG",735,488,1244,2016-12-16,-247
Ersan Ilyasova,PHI ," SF,PF",972,246,1231,2016-12-16,-726
K. Korver,CLE ," SG,SF",282,891,1182,2016-12-16,609
Justise Winslow,MIA ," SF,PF",378,787,1168,2016-12-16,409
Ish Smith,DET , PG,967,177,1144,2016-12-16,-790
Michael Kidd-Gilchrist,CHA , SF,884,205,1100,2016-12-16,-679
Courtney Lee,NY ," SG,SF",660,433,1097,2016-12-16,-227
Aaron Gordon,ORL ," SF,PF",215,866,1094,2016-12-16,651
Danny Green,SA ," SG,SF",1038,36,1077,2016-12-16,-1002
Marcus Smart,BOS , PG,858,197,1065,2016-12-16,-661
Sean Kilpatrick,BKN ," PG,SG",578,464,1063,2016-12-16,-114
Emmanuel Mudiay,DEN , PG,773,265,1050,2016-12-16,-508
Kenneth Faried,DEN ," PF,C",282,723,1020,2016-12-16,441
Matthew Dellavedova,MIL ," PG,SG",806,198,1010,2016-12-16,-608
Garrett Temple,SAC ," PG,SG",116,7676,7792,2016-12-17,7560
Kyle O'Quinn,NY ," PF,C",4564,251,4821,2016-12-17,-4313
Kosta Koufos,SAC ," PF,C",60,3650,3710,2016-12-17,3590
Tony Allen,MEM ," SG,SF",256,3300,3560,2016-12-17,3044
Dorian Finney-Smith,DAL ," SF,PF",3421,120,3545,2016-12-17,-3301
Jon Leuer,DET ," PF,C",1181,1639,2828,2016-12-17,458
Michael Kidd-Gilchrist,CHA , SF,2431,52,2489,2016-12-17,-2379
Nikola Mirotic,CHI ," SF,PF",2404,56,2468,2016-12-17,-2348
JaMychal Green,MEM , PF,2050,231,2306,2016-12-17,-1819
Justise Winslow,MIA ," SF,PF",209,2072,2287,2016-12-17,1863
Gary Harris,DEN ," SG,SF",292,1925,2219,2016-12-17,1633
Nick Young,LAL ," SG,SF",489,1716,2211,2016-12-17,1227
Kelly Oubre Jr.,WAS , SF,1727,447,2176,2016-12-17,-1280
Jusuf Nurkic,DEN , C,2071,56,2145,2016-12-17,-2015
Thabo Sefolosha,ATL ," SG,SF",1518,553,2076,2016-12-17,-965
Langston Galloway,NO ," PG,SG",1979,80,2061,2016-12-17,-1899
K. Korver,CLE ," SG,SF",476,1452,1938,2016-12-17,976
John Henson,MIL ," PF,C",1623,203,1840,2016-12-17,-1420
Ish Smith,DET , PG,1687,81,1773,2016-12-17,-1606
Terrence Jones,NO ," SF,PF",278,1463,1750,2016-12-17,1185
Will Barton,DEN ," SG,SF",1387,342,1743,2016-12-17,-1045
Marquese Chriss,PHO , PF,540,1135,1675,2016-12-17,595
Wayne Ellington,MIA ," SG,SF",1591,49,1645,2016-12-17,-1542
Sergio Rodriguez,PHI , PG,1128,482,1619,2016-12-17,-646
Patrick Beverley,HOU ," PG,SG",297,1301,1609,2016-12-17,1004
C.J. Miles,IND ," SG,SF",1418,177,1605,2016-12-17,-1241
Luol Deng,LAL ," SF,PF",733,782,1519,2016-12-17,49
Dwight Powell,DAL ," PF,C",1164,297,1469,2016-12-17,-867
T.J. McConnell,PHI , PG,151,1282,1433,2016-12-17,1131
Dirk Nowitzki,DAL ," PF,C",201,1211,1417,2016-12-17,1010
Cody Zeller,CHA ," PF,C",539,860,1409,2016-12-17,321
Marco Belinelli,CHA ," SG,SF",728,669,1399,2016-12-17,-59
Jahlil Okafor,PHI , C,142,1191,1348,2016-12-17,1049
Brandon Jennings,NY , PG,938,344,1288,2016-12-17,-594
Patty Mills,SA , PG,909,363,1282,2016-12-17,-546
Robert Covington,PHI ," SF,PF",337,920,1263,2016-12-17,583
Andrew Harrison,MEM ," PG,SG",1227,25,1253,2016-12-17,-1202
Marvin Williams,CHA ," SF,PF",543,691,1243,2016-12-17,148
Tim Frazier,NO ," PG,SG",399,788,1198,2016-12-17,389
Dario Saric,PHI ," SF,PF",1093,89,1187,2016-12-17,-1004
Courtney Lee,NY ," SG,SF",893,289,1186,2016-12-17,-604
Tim Hardaway Jr.,ATL ," SG,SF",315,867,1183,2016-12-17,552
Tyler Johnson,MIA ," PG,SG",941,212,1165,2016-12-17,-729
Marcus Morris,DET ," SF,PF",1046,87,1159,2016-12-17,-959
Terrence Ross,TOR ," SG,SF",267,883,1151,2016-12-17,616
Tyson Chandler,PHO , C,716,409,1144,2016-12-17,-307
Brandon Knight,PHO ," PG,SG",911,202,1127,2016-12-17,-709
Evan Turner,POR ," SG,SF",848,268,1122,2016-12-17,-580
Emmanuel Mudiay,DEN , PG,583,528,1120,2016-12-17,-55
Maurice Harkless,POR , SF,771,324,1117,2016-12-17,-447
Kyle O'Quinn,NY ," PF,C",5221,65,5292,2016-12-18,-5156
Garrett Temple,SAC ," PG,SG",1157,4082,5240,2016-12-18,2925
Nick Young,LAL ," SG,SF",189,4766,4964,2016-12-18,4577
Tim Hardaway Jr.,ATL ," SG,SF",266,4097,4366,2016-12-18,3831
Jusuf Nurkic,DEN , C,3301,116,3432,2016-12-18,-3185
Michael Kidd-Gilchrist,CHA , SF,3127,39,3181,2016-12-18,-3088
Emmanuel Mudiay,DEN , PG,239,2856,3099,2016-12-18,2617
Kosta Koufos,SAC ," PF,C",763,2283,3047,2016-12-18,1520
J.J. Barea,DAL ," PG,SG",121,2851,2975,2016-12-18,2730
Tony Allen,MEM ," SG,SF",618,1846,2472,2016-12-18,1228
Jon Leuer,DET ," PF,C",1641,640,2289,2016-12-18,-1001
Thabo Sefolosha,ATL ," SG,SF",1552,668,2230,2016-12-18,-884
Marco Belinelli,CHA ," SG,SF",360,1751,2116,2016-12-18,1391
Guillermo Hernangomez,NY , C,65,2043,2108,2016-12-18,1978
Marvin Williams,CHA ," SF,PF",326,1742,2073,2016-12-18,1416
Luol Deng,LAL ," SF,PF",422,1615,2038,2016-12-18,1193
Kenneth Faried,DEN ," PF,C",150,1684,1848,2016-12-18,1534
C.J. Miles,IND ," SG,SF",1032,762,1797,2016-12-18,-270
Will Barton,DEN ," SG,SF",660,1070,1755,2016-12-18,410
Tim Frazier,NO ," PG,SG",502,1238,1750,2016-12-18,736
Wayne Ellington,MIA ," SG,SF",1620,43,1666,2016-12-18,-1577
JaMychal Green,MEM , PF,1306,323,1643,2016-12-18,-983
Gary Harris,DEN ," SG,SF",221,1411,1636,2016-12-18,1190
Marreese Speights,LAC ," PF,C",85,1520,1606,2016-12-18,1435
Dorian Finney-Smith,DAL ," SF,PF",956,606,1567,2016-12-18,-350
Kent Bazemore,ATL ," SG,SF",329,1228,1563,2016-12-18,899
John Henson,MIL ," PF,C",1284,254,1561,2016-12-18,-1030
Troy Daniels,MEM ," PG,SG",1295,201,1499,2016-12-18,-1094
Sean Kilpatrick,BKN ," PG,SG",1128,336,1479,2016-12-18,-792
Cody Zeller,CHA ," PF,C",461,1004,1471,2016-12-18,543
Tyson Chandler,PHO , C,573,877,1467,2016-12-18,304
Sergio Rodriguez,PHI , PG,1138,302,1450,2016-12-18,-836
Patrick Patterson,TOR ," PF,C",991,448,1442,2016-12-18,-543
Ish Smith,DET , PG,1332,99,1436,2016-12-18,-1233
Seth Curry,DAL ," PG,SG",192,1237,1430,2016-12-18,1045
Nerlens Noel,PHI ," PF,C",1112,288,1417,2016-12-18,-824
Tyler Johnson,MIA ," SF,PF",899,492,1393,2016-12-18,-407
K. Korver,CLE ," SG,SF",596,783,1385,2016-12-18,187
Patty Mills,SA , PG,874,443,1327,2016-12-18,-431
Justise Winslow,MIA ," SF,PF",331,972,1309,2016-12-18,641
Kelly Oubre Jr.,WAS , SF,1221,83,1305,2016-12-18,-1138
T.J. McConnell,PHI , PG,462,827,1291,2016-12-18,365
Alex Len,PHO ," PF,C",519,756,1282,2016-12-18,237
Josh Richardson,MIA ," SG,SF",1078,179,1265,2016-12-18,-899
Evan Turner,POR ," SG,SF",1183,76,1262,2016-12-18,-1107
Dwight Powell,DAL ," PF,C",817,433,1250,2016-12-18,-384
DeMarre Carroll,TOR ," SF,PF",976,256,1242,2016-12-18,-720
Terrence Jones,NO ," SF,PF",576,639,1226,2016-12-18,63
Andrew Harrison,MEM ," PG,SG",1173,33,1208,2016-12-18,-1140
Nikola Mirotic,CHI ," SF,PF",1051,143,1199,2016-12-18,-908
Marreese Speights,LAC ," PF,C",203,17860,18064,2016-12-19,17657
J.J. Barea,DAL ," PG,SG",292,8070,8363,2016-12-19,7778
Nick Young,LAL ," SG,SF",232,5207,5450,2016-12-19,4975
Tim Hardaway Jr.,ATL ," SG,SF",1741,2992,4735,2016-12-19,1251
Clint Capela,HOU ," PF,C",4047,68,4142,2016-12-19,-3979
Kyle O'Quinn,NY ," PF,C",4024,85,4117,2016-12-19,-3939
Garrett Temple,SAC ," PG,SG",2241,1819,4060,2016-12-19,-422
Emmanuel Mudiay,DEN , PG,316,3405,3730,2016-12-19,3089
Jusuf Nurkic,DEN , C,3379,196,3586,2016-12-19,-3183
Marco Belinelli,CHA ," SG,SF",266,3297,3563,2016-12-19,3031
Guillermo Hernangomez,NY , C,192,3358,3550,2016-12-19,3166
Dorian Finney-Smith,DAL ," SF,PF",1560,1797,3359,2016-12-19,237
Wayne Ellington,MIA ," SG,SF",3120,45,3167,2016-12-19,-3075
Montrezl Harrell,HOU ," PF,C",50,3019,3069,2016-12-19,2969
Kent Bazemore,ATL ," SG,SF",366,2460,2834,2016-12-19,2094
Marvin Williams,CHA ," SF,PF",356,2443,2807,2016-12-19,2087
Josh Richardson,MIA ," SG,SF",2712,62,2777,2016-12-19,-2650
Jon Leuer,DET ," PF,C",596,2150,2752,2016-12-19,1554
Cody Zeller,CHA ," PF,C",305,2400,2713,2016-12-19,2095
Tony Allen,MEM ," SG,SF",951,1622,2575,2016-12-19,671
Luol Deng,LAL ," SF,PF",463,1975,2441,2016-12-19,1512
Will Barton,DEN ," SG,SF",835,1487,2340,2016-12-19,652
Tim Frazier,NO ," PG,SG",500,1776,2286,2016-12-19,1276
Gary Harris,DEN ," SG,SF",192,2067,2269,2016-12-19,1875
Nerlens Noel,PHI ," PF,C",1982,218,2212,2016-12-19,-1764
Dwight Powell,DAL ," PF,C",1493,675,2168,2016-12-19,-818
John Henson,MIL ," PF,C",1381,740,2134,2016-12-19,-641
Bismack Biyombo,ORL ," PF,C",319,1787,2110,2016-12-19,1468
Kenneth Faried,DEN ," PF,C",633,1424,2065,2016-12-19,791
Seth Curry,DAL ," PG,SG",555,1476,2033,2016-12-19,921
Alex Len,PHO ," PF,C",989,965,1957,2016-12-19,-24
Sean Kilpatrick,BKN ," PG,SG",1644,299,1955,2016-12-19,-1345
JaMychal Green,MEM , PF,1052,873,1944,2016-12-19,-179
C.J. Miles,IND ," SG,SF",1042,887,1932,2016-12-19,-155
Kosta Koufos,SAC ," PF,C",1283,636,1919,2016-12-19,-647
T.J. Warren,PHO , SF,1412,489,1908,2016-12-19,-923
Sergio Rodriguez,PHI , PG,1605,284,1899,2016-12-19,-1321
Tyler Johnson,MIA ," SF,PF",1678,153,1832,2016-12-19,-1525
Marcus Morris,DET ," SF,PF",1601,181,1797,2016-12-19,-1420
Tyson Chandler,PHO , C,596,1180,1792,2016-12-19,584
Michael Kidd-Gilchrist,CHA , SF,1675,101,1785,2016-12-19,-1574
Thabo Sefolosha,ATL ," SG,SF",1110,647,1763,2016-12-19,-463
Troy Daniels,MEM ," PG,SG",1737,25,1763,2016-12-19,-1712
Ersan Ilyasova,PHI ," SF,PF",322,1418,1748,2016-12-19,1096
Nikola Mirotic,CHI ," SF,PF",1079,664,1746,2016-12-19,-415
Patrick Patterson,TOR ," PF,C",1480,243,1726,2016-12-19,-1237
Marquese Chriss,PHO , PF,885,765,1651,2016-12-19,-120
Patty Mills,SA , PG,940,685,1634,2016-12-19,-255
DeMarre Carroll,TOR ," SF,PF",1359,240,1608,2016-12-19,-1119
Tyreke Evans,NO ," PG,SG,SF",1351,231,1593,2016-12-19,-1120
J.J. Barea,DAL ," PG,SG",212,8126,8339,2016-12-20,7914
Clint Capela,HOU ," PF,C",6324,70,6408,2016-12-20,-6254
Jon Leuer,DET ," PF,C",205,5778,5990,2016-12-20,5573
Marreese Speights,LAC ," PF,C",1815,3012,4827,2016-12-20,1197
Montrezl Harrell,HOU ," PF,C",216,3976,4192,2016-12-20,3760
Marcus Morris,DET ," SF,PF",3472,173,3662,2016-12-20,-3299
Emmanuel Mudiay,DEN , PG,658,2835,3502,2016-12-20,2177
Jusuf Nurkic,DEN , C,3357,101,3464,2016-12-20,-3256
Nick Young,LAL ," SG,SF",235,2720,2961,2016-12-20,2485
Guillermo Hernangomez,NY , C,1769,1083,2853,2016-12-20,-686
Dwight Powell,DAL ," PF,C",483,2141,2624,2016-12-20,1658
Kent Bazemore,ATL ," SG,SF",254,2289,2548,2016-12-20,2035
Dorian Finney-Smith,DAL ," SF,PF",2101,426,2527,2016-12-20,-1675
Sean Kilpatrick,BKN ," PG,SG",2194,183,2393,2016-12-20,-2011
Garrett Temple,SAC ," PG,SG",1186,1142,2330,2016-12-20,-44
Tim Hardaway Jr.,ATL ," SG,SF",1961,180,2142,2016-12-20,-1781
Will Barton,DEN ," SG,SF",1489,625,2131,2016-12-20,-864
Gary Harris,DEN ," SG,SF",301,1793,2105,2016-12-20,1492
Marco Belinelli,CHA ," SG,SF",416,1689,2105,2016-12-20,1273
Nene Hilario,HOU ," PF,C",62,2036,2098,2016-12-20,1974
Cody Zeller,CHA ," PF,C",390,1656,2059,2016-12-20,1266
Nikola Mirotic,CHI ," SF,PF",327,1655,1989,2016-12-20,1328
Thabo Sefolosha,ATL ," SG,SF",392,1453,1846,2016-12-20,1061
Marvin Williams,CHA ," SF,PF",327,1494,1827,2016-12-20,1167
J.R. Smith,CLE ," SG,SF",1064,684,1751,2016-12-20,-380
John Henson,MIL ," PF,C",592,1033,1637,2016-12-20,441
Kyle O'Quinn,NY ," PF,C",1484,147,1636,2016-12-20,-1337
Seth Curry,DAL ," PG,SG",431,1185,1617,2016-12-20,754
Wayne Ellington,MIA ," SG,SF",1546,32,1579,2016-12-20,-1514
Sergio Rodriguez,PHI , PG,1397,147,1547,2016-12-20,-1250
Tyson Chandler,PHO , C,395,1069,1478,2016-12-20,674
Luol Deng,LAL ," SF,PF",390,1044,1436,2016-12-20,654
Kenneth Faried,DEN ," PF,C",1176,231,1417,2016-12-20,-945
Bismack Biyombo,ORL ," PF,C",401,1006,1413,2016-12-20,605
Tony Allen,MEM ," SG,SF",475,906,1385,2016-12-20,431
JaMychal Green,MEM , PF,504,858,1375,2016-12-20,354
Alex Len,PHO ," PF,C",911,428,1345,2016-12-20,-483
T.J. Warren,PHO , SF,1081,235,1322,2016-12-20,-846
Tim Frazier,NO ," PG,SG",284,989,1279,2016-12-20,705
Terrence Jones,NO ," SF,PF",316,935,1261,2016-12-20,619
C.J. Miles,IND ," SG,SF",955,290,1247,2016-12-20,-665
Shelvin Mack,UTA , PG,219,1022,1242,2016-12-20,803
Marcus Smart,BOS , PG,1090,123,1221,2016-12-20,-967
Chandler Parsons,MEM ," SF,PF",144,1048,1200,2016-12-20,904
Tyler Johnson,MIA ," PG,SG",578,583,1170,2016-12-20,5
Ersan Ilyasova,PHI ," SF,PF",371,752,1141,2016-12-20,381
Patrick Patterson,TOR ," PF,C",987,138,1128,2016-12-20,-849
Maurice Harkless,POR , SF,310,804,1124,2016-12-20,494
Kosta Koufos,SAC ," PF,C",694,421,1115,2016-12-20,-273
Brandon Jennings,NY , PG,927,184,1115,2016-12-20,-743
J.R. Smith,CLE ," SG,SF",6390,65,6463,2016-12-21,-6325
J.J. Barea,DAL ," PG,SG",1902,3064,4970,2016-12-21,1162
Luol Deng,LAL ," SF,PF",207,4720,4931,2016-12-21,4513
Nick Young,LAL ," SG,SF",127,3551,3689,2016-12-21,3424
Marreese Speights,LAC ," PF,C",3016,641,3657,2016-12-21,-2375
Jon Leuer,DET ," PF,C",341,3034,3384,2016-12-21,2693
Sean Kilpatrick,BKN ," PG,SG",3121,240,3374,2016-12-21,-2881
Tyler Johnson,MIA ," PG,SG",104,3193,3311,2016-12-21,3089
Garrett Temple,SAC ," PG,SG",2961,236,3199,2016-12-21,-2725
Clint Capela,HOU ," PF,C",2757,108,2879,2016-12-21,-2649
Iman Shumpert,CLE ," SG,SF",102,2701,2804,2016-12-21,2599
Austin Rivers,LAC ," PG,SG,SF",222,2502,2726,2016-12-21,2280
Danny Green,SA ," SG,SF",192,2402,2599,2016-12-21,2210
Joakim Noah,NY ," PF,C",181,2268,2454,2016-12-21,2087
Tony Allen,MEM ," SG,SF",1624,748,2382,2016-12-21,-876
Troy Daniels,MEM ," PG,SG",476,1827,2304,2016-12-21,1351
Dorian Finney-Smith,DAL ," SF,PF",1686,188,1874,2016-12-21,-1498
Emmanuel Mudiay,DEN , PG,1632,212,1856,2016-12-21,-1420
Tyler Johnson,MIA ," SF,PF",220,1628,1854,2016-12-21,1408
Dwight Powell,DAL ," PF,C",583,1214,1802,2016-12-21,631
John Henson,MIL ," PF,C",647,1137,1793,2016-12-21,490
Jusuf Nurkic,DEN , C,1700,76,1781,2016-12-21,-1624
Chandler Parsons,MEM ," SF,PF",187,1575,1768,2016-12-21,1388
Ty Lawson,SAC , PG,109,1651,1760,2016-12-21,1542
Montrezl Harrell,HOU ," PF,C",422,1313,1735,2016-12-21,891
Terrence Jones,NO ," SF,PF",297,1425,1730,2016-12-21,1128
Marcus Morris,DET ," SF,PF",1519,181,1726,2016-12-21,-1338
Guillermo Hernangomez,NY , C,1574,102,1677,2016-12-21,-1472
Patty Mills,SA , PG,410,1235,1652,2016-12-21,825
Tim Hardaway Jr.,ATL ," SG,SF",1557,78,1637,2016-12-21,-1479
Rondae Hollis-Jefferson,BKN ," SG,SF",227,1406,1634,2016-12-21,1179
Kosta Koufos,SAC ," PF,C",1531,62,1594,2016-12-21,-1469
Will Barton,DEN ," SG,SF",455,1113,1582,2016-12-21,658
C.J. Miles,IND ," SG,SF",619,934,1558,2016-12-21,315
Nikola Mirotic,CHI ," SF,PF",354,1172,1532,2016-12-21,818
Larry Nance Jr.,LAL , PF,1451,65,1518,2016-12-21,-1386
Thabo Sefolosha,ATL ," SG,SF",681,832,1518,2016-12-21,151
Kent Bazemore,ATL ," SG,SF",344,1091,1442,2016-12-21,747
Kyle O'Quinn,NY ," PF,C",1005,427,1435,2016-12-21,-578
Tyson Chandler,PHO , C,893,524,1430,2016-12-21,-369
Langston Galloway,NO ," PG,SG",1355,65,1422,2016-12-21,-1290
Marco Belinelli,CHA ," SG,SF",394,1006,1403,2016-12-21,612
Sergio Rodriguez,PHI , PG,1222,140,1371,2016-12-21,-1082
Courtney Lee,NY ," SG,SF",409,888,1299,2016-12-21,479
JaMychal Green,MEM , PF,703,582,1297,2016-12-21,-121
Bismack Biyombo,ORL ," PF,C",352,909,1274,2016-12-21,557
Evan Turner,POR ," SG,SF",1222,39,1263,2016-12-21,-1183
Marcus Smart,BOS , PG,969,272,1247,2016-12-21,-697
Seth Curry,DAL ," PG,SG",524,698,1229,2016-12-21,174
Marvin Williams,CHA ," SF,PF",355,820,1186,2016-12-21,465
J.J. Barea,DAL ," PG,SG",4233,202,4446,2016-12-22,-4031
Luol Deng,LAL ," SF,PF",165,3213,3382,2016-12-22,3048
Montrezl Harrell,HOU ," PF,C",198,3109,3308,2016-12-22,2911
Dwight Powell,DAL ," PF,C",317,2329,2649,2016-12-22,2012
J.R. Smith,CLE ," SG,SF",2493,28,2530,2016-12-22,-2465
Ty Lawson,SAC , PG,173,2203,2376,2016-12-22,2030
Nick Young,LAL ," SG,SF",98,2126,2234,2016-12-22,2028
Tony Allen,MEM ," SG,SF",1976,240,2224,2016-12-22,-1736
Tyler Johnson,MIA ," SF,PF",240,1849,2091,2016-12-22,1609
Dorian Finney-Smith,DAL ," SF,PF",2011,55,2069,2016-12-22,-1956
Malcolm Brogdon,MIL ," PG,SG",79,1875,1954,2016-12-22,1796
Tyler Johnson,MIA ," PG,SG",191,1749,1953,2016-12-22,1558
Kyle O'Quinn,NY ," PF,C",599,1259,1859,2016-12-22,660
Justise Winslow,MIA ," SF,PF",188,1660,1857,2016-12-22,1472
Jon Leuer,DET ," PF,C",255,1546,1817,2016-12-22,1291
Marreese Speights,LAC ," PF,C",1354,397,1755,2016-12-22,-957
Austin Rivers,LAC ," PG,SG,SF",376,1192,1568,2016-12-22,816
Sean Kilpatrick,BKN ," PG,SG",1236,308,1559,2016-12-22,-928
Danny Green,SA ," SG,SF",247,1297,1553,2016-12-22,1050
Joakim Noah,NY ," PF,C",387,1135,1528,2016-12-22,748
Tim Hardaway Jr.,ATL ," SG,SF",1457,28,1488,2016-12-22,-1429
Rondae Hollis-Jefferson,BKN ," SG,SF",198,1269,1469,2016-12-22,1071
T.J. Warren,PHO , SF,171,1267,1448,2016-12-22,1096
Larry Nance Jr.,LAL , PF,1336,16,1352,2016-12-22,-1320
Tyson Chandler,PHO , C,1121,211,1349,2016-12-22,-910
Will Barton,DEN ," SG,SF",225,1091,1334,2016-12-22,866
Marcus Morris,DET ," SF,PF",1121,186,1333,2016-12-22,-935
Patty Mills,SA , PG,453,856,1318,2016-12-22,403
Clint Capela,HOU ," PF,C",1106,190,1312,2016-12-22,-916
Garrett Temple,SAC ," PG,SG",1156,135,1293,2016-12-22,-1021
Seth Curry,DAL ," PG,SG",427,845,1274,2016-12-22,418
John Henson,MIL ," PF,C",781,394,1185,2016-12-22,-387
C.J. Miles,IND ," SG,SF",517,629,1150,2016-12-22,112
Nikola Mirotic,CHI ," SF,PF",362,687,1056,2016-12-22,325
Thabo Sefolosha,ATL ," SG,SF",516,538,1055,2016-12-22,22
Trevor Booker,BKN , PF,777,224,1028,2016-12-22,-553
Jusuf Nurkic,DEN , C,909,78,994,2016-12-22,-831
Wayne Ellington,MIA ," SG,SF",939,24,965,2016-12-22,-915
Terrence Jones,NO ," SF,PF",274,666,953,2016-12-22,392
Troy Daniels,MEM ," PG,SG",833,99,936,2016-12-22,-734
Marco Belinelli,CHA ," SG,SF",253,675,935,2016-12-22,422
Evan Turner,POR ," SG,SF",888,22,913,2016-12-22,-866
Brandon Ingram,LAL ," SG,SF",336,566,906,2016-12-22,230
Bismack Biyombo,ORL ," PF,C",209,680,903,2016-12-22,471
Alex Len,PHO ," PF,C",342,554,898,2016-12-22,212
Aaron Gordon,ORL ," SF,PF",477,398,884,2016-12-22,-79
JaMychal Green,MEM , PF,543,327,878,2016-12-22,-216
Iman Shumpert,CLE ," SG,SF",178,689,867,2016-12-22,511
Patrick Beverley,HOU ," PG,SG",108,729,861,2016-12-22,621
Marvin Williams,CHA ," SF,PF",224,615,849,2016-12-22,391
Khris Middleton,MIL ," SG,SF",78,4595,4674,2016-12-23,4517
Kyle O'Quinn,NY ," PF,C",199,3670,3869,2016-12-23,3471
Justise Winslow,MIA ," SF,PF",143,3306,3460,2016-12-23,3163
Dirk Nowitzki,DAL ," PF,C",134,2816,2958,2016-12-23,2682
Tyler Johnson,MIA ," SF,PF",219,2699,2921,2016-12-23,2480
J.J. Barea,DAL ," PG,SG",2713,114,2838,2016-12-23,-2599
J.R. Smith,CLE ," SG,SF",2523,35,2563,2016-12-23,-2488
Ty Lawson,SAC , PG,182,2204,2390,2016-12-23,2022
Malcolm Brogdon,MIL ," PG,SG",118,1950,2068,2016-12-23,1832
Marreese Speights,LAC ," PF,C",549,1421,1970,2016-12-23,872
Trevor Booker,BKN , PF,1823,109,1952,2016-12-23,-1714
Montrezl Harrell,HOU ," PF,C",186,1723,1910,2016-12-23,1537
Luol Deng,LAL ," SF,PF",230,1485,1716,2016-12-23,1255
Sean Kilpatrick,BKN ," PG,SG",1291,319,1623,2016-12-23,-972
Tony Allen,MEM ," SG,SF",1351,142,1500,2016-12-23,-1209
Tim Frazier,NO ," PG,SG",1276,213,1497,2016-12-23,-1063
Marcus Morris,DET ," SF,PF",1206,246,1470,2016-12-23,-960
Dwight Powell,DAL ," PF,C",737,710,1452,2016-12-23,-27
John Henson,MIL ," PF,C",1190,180,1380,2016-12-23,-1010
Nick Young,LAL ," SG,SF",221,1106,1346,2016-12-23,885
Dorian Finney-Smith,DAL ," SF,PF",1239,43,1283,2016-12-23,-1196
Marco Belinelli,CHA ," SG,SF",966,310,1277,2016-12-23,-656
Will Barton,DEN ," SG,SF",237,1027,1276,2016-12-23,790
Rondae Hollis-Jefferson,BKN ," SG,SF",318,899,1217,2016-12-23,581
Bojan Bogdanovic,BKN ," SG,SF",1113,72,1194,2016-12-23,-1041
Iman Shumpert,CLE ," SG,SF",219,947,1169,2016-12-23,728
Tyler Johnson,MIA ," PG,SG",394,760,1167,2016-12-23,366
Patty Mills,SA , PG,749,382,1137,2016-12-23,-367
Jon Leuer,DET ," PF,C",246,842,1101,2016-12-23,596
C.J. Miles,IND ," SG,SF",441,626,1077,2016-12-23,185
JaMychal Green,MEM , PF,871,190,1073,2016-12-23,-681
Clint Capela,HOU ," PF,C",711,320,1043,2016-12-23,-391
Michael Kidd-Gilchrist,CHA , SF,400,623,1033,2016-12-23,223
T.J. Warren,PHO , SF,133,850,991,2016-12-23,717
Darren Collison,SAC , PG,883,66,969,2016-12-23,-817
Jusuf Nurkic,DEN , C,876,79,965,2016-12-23,-797
Austin Rivers,LAC ," PG,SG,SF",418,523,942,2016-12-23,105
Nikola Mirotic,CHI ," SF,PF",208,711,926,2016-12-23,503
Cody Zeller,CHA ," PF,C",201,665,876,2016-12-23,464
Josh Richardson,MIA ," SG,SF",797,73,873,2016-12-23,-724
Garrett Temple,SAC ," PG,SG",740,113,853,2016-12-23,-627
Marvin Williams,CHA ," SF,PF",349,488,847,2016-12-23,139
Joakim Noah,NY ," PF,C",455,384,846,2016-12-23,-71
Danny Green,SA ," SG,SF",427,387,817,2016-12-23,-40
Seth Curry,DAL ," PG,SG",332,467,800,2016-12-23,135
Tyson Chandler,PHO , C,610,166,793,2016-12-23,-444
Jamal Crawford,LAC ," SG,SF",298,482,784,2016-12-23,184
Sergio Rodriguez,PHI , PG,567,199,776,2016-12-23,-368
Brandon Jennings,NY , PG,255,509,770,2016-12-23,254
Maurice Harkless,POR , SF,524,220,760,2016-12-23,-304
Malcolm Brogdon,MIL ," PG,SG",137,4222,4359,2016-12-25,4085
Kyle O'Quinn,NY ," PF,C",2328,939,3270,2016-12-25,-1389
Montrezl Harrell,HOU ," PF,C",128,2643,2773,2016-12-25,2515
P.J. Tucker,PHO ," SG,SF",87,2424,2512,2016-12-25,2337
Marcus Morris,DET ," SF,PF",2030,132,2181,2016-12-25,-1898
Tim Frazier,NO ," PG,SG",2005,80,2099,2016-12-25,-1925
Marreese Speights,LAC ," PF,C",941,1039,1985,2016-12-25,98
Ty Lawson,SAC , PG,124,1846,1972,2016-12-25,1722
Lucas Nogueira,TOR ," PF,C",96,1787,1884,2016-12-25,1691
Patty Mills,SA , PG,1021,643,1672,2016-12-25,-378
Bojan Bogdanovic,BKN ," SG,SF",1520,57,1585,2016-12-25,-1463
Luol Deng,LAL ," SF,PF",365,1078,1450,2016-12-25,713
Austin Rivers,LAC ," PG,SG,SF",751,676,1429,2016-12-25,-75
Jamal Crawford,LAC ," SG,SF",263,1109,1377,2016-12-25,846
Brandon Jennings,NY , PG,1167,175,1343,2016-12-25,-992
J.J. Barea,DAL ," PG,SG",1001,273,1277,2016-12-25,-728
Thabo Sefolosha,ATL ," SG,SF",134,1130,1269,2016-12-25,996
John Henson,MIL ," PF,C",1123,133,1264,2016-12-25,-990
J.R. Smith,CLE ," SG,SF",1210,43,1256,2016-12-25,-1167
Nikola Mirotic,CHI ," SF,PF",165,1048,1221,2016-12-25,883
Michael Kidd-Gilchrist,CHA , SF,157,1010,1170,2016-12-25,853
Andre Roberson,OKC ," SG,SF",698,444,1144,2016-12-25,-254
Tyler Johnson,MIA ," SF,PF",261,874,1135,2016-12-25,613
Tony Allen,MEM ," SG,SF",705,365,1078,2016-12-25,-340
Dirk Nowitzki,DAL ," PF,C",112,951,1074,2016-12-25,839
Cody Zeller,CHA ," PF,C",126,917,1051,2016-12-25,791
Nick Young,LAL ," SG,SF",361,583,955,2016-12-25,222
Danny Green,SA ," SG,SF",778,170,953,2016-12-25,-608
Sean Kilpatrick,BKN ," PG,SG",534,399,949,2016-12-25,-135
Dwight Powell,DAL ," PF,C",516,410,931,2016-12-25,-106
Jon Leuer,DET ," PF,C",226,667,906,2016-12-25,441
Joakim Noah,NY ," PF,C",459,411,877,2016-12-25,-48
Raymond Felton,LAC ," PG,SG",86,780,866,2016-12-25,694
C.J. Miles,IND ," SG,SF",315,536,856,2016-12-25,221
Marco Belinelli,CHA ," SG,SF",815,35,855,2016-12-25,-780
JaMychal Green,MEM , PF,647,183,840,2016-12-25,-464
Darren Collison,SAC , PG,743,64,825,2016-12-25,-679
Courtney Lee,NY ," SG,SF",566,245,812,2016-12-25,-321
Will Barton,DEN ," SG,SF",200,585,804,2016-12-25,385
Guillermo Hernangomez,NY , C,709,77,786,2016-12-25,-632
Elfrid Payton,ORL , PG,104,662,782,2016-12-25,558
Channing Frye,CLE ," PF,C",261,512,774,2016-12-25,251
Seth Curry,DAL ," PG,SG",242,508,753,2016-12-25,266
Maurice Harkless,POR , SF,531,201,752,2016-12-25,-330
Justise Winslow,MIA ," SF,PF",179,561,750,2016-12-25,382
Trevor Booker,BKN , PF,556,165,740,2016-12-25,-391
Bismack Biyombo,ORL ," PF,C",233,485,726,2016-12-25,252
Manu Ginobili,SA ," SG,SF",298,425,724,2016-12-25,127
Amir Johnson,BOS ," PF,C",323,396,719,2016-12-25,73
Dorian Finney-Smith,DAL ," SF,PF",668,34,703,2016-12-25,-634
Malcolm Brogdon,MIL ," PG,SG",1361,5274,6637,2016-12-26,3913
Tyler Johnson,MIA ," SF,PF",207,5017,5228,2016-12-26,4810
Montrezl Harrell,HOU ," PF,C",232,4964,5198,2016-12-26,4732
Tim Frazier,NO ," PG,SG",4764,152,4924,2016-12-26,-4612
J.J. Barea,DAL ," PG,SG",4200,302,4509,2016-12-26,-3898
Raymond Felton,LAC ," PG,SG",374,4073,4447,2016-12-26,3699
Kyle O'Quinn,NY ," PF,C",3395,145,3542,2016-12-26,-3250
Shelvin Mack,UTA , PG,100,3350,3453,2016-12-26,3250
P.J. Tucker,PHO ," SG,SF",839,2448,3288,2016-12-26,1609
Ty Lawson,SAC , PG,341,2646,2990,2016-12-26,2305
Luol Deng,LAL ," SF,PF",318,2623,2944,2016-12-26,2305
Patty Mills,SA , PG,2496,431,2933,2016-12-26,-2065
Seth Curry,DAL ," PG,SG",210,2678,2888,2016-12-26,2468
Marreese Speights,LAC ," PF,C",2059,702,2762,2016-12-26,-1357
Lucas Nogueira,TOR ," PF,C",287,2458,2747,2016-12-26,2171
Michael Kidd-Gilchrist,CHA , SF,240,2086,2332,2016-12-26,1846
Sean Kilpatrick,BKN ," PG,SG",543,1735,2291,2016-12-26,1192
Nikola Mirotic,CHI ," SF,PF",287,1953,2248,2016-12-26,1666
Brandon Jennings,NY , PG,2084,74,2163,2016-12-26,-2010
Thabo Sefolosha,ATL ," SG,SF",240,1854,2099,2016-12-26,1614
John Henson,MIL ," PF,C",1845,239,2090,2016-12-26,-1606
Tony Allen,MEM ," SG,SF",901,1130,2036,2016-12-26,229
Austin Rivers,LAC ," PG,SG,SF",1693,242,1936,2016-12-26,-1451
Dwight Powell,DAL ," PF,C",832,1102,1936,2016-12-26,270
Marco Belinelli,CHA ," SG,SF",1778,59,1840,2016-12-26,-1719
Justise Winslow,MIA ," SF,PF",227,1587,1821,2016-12-26,1360
Joe Ingles,UTA ," SG,SF",93,1723,1816,2016-12-26,1630
Marcus Morris,DET ," SF,PF",1286,475,1771,2016-12-26,-811
C.J. Miles,IND ," SG,SF",977,751,1735,2016-12-26,-226
JaMychal Green,MEM , PF,1038,627,1670,2016-12-26,-411
Nick Young,LAL ," SG,SF",382,1266,1655,2016-12-26,884
Jamal Crawford,LAC ," SG,SF",509,1140,1651,2016-12-26,631
Kent Bazemore,ATL ," SG,SF",1418,212,1642,2016-12-26,-1206
Cody Zeller,CHA ," PF,C",229,1395,1634,2016-12-26,1166
Tyler Johnson,MIA ," PG,SG",252,1313,1576,2016-12-26,1061
Sergio Rodriguez,PHI , PG,224,1345,1575,2016-12-26,1121
Bojan Bogdanovic,BKN ," SG,SF",1229,257,1495,2016-12-26,-972
Danny Green,SA ," SG,SF",1364,96,1462,2016-12-26,-1268
Dirk Nowitzki,DAL ," PF,C",283,1151,1445,2016-12-26,868
Jon Leuer,DET ," PF,C",344,1089,1438,2016-12-26,745
Marcus Smart,BOS , PG,315,1084,1401,2016-12-26,769
Will Barton,DEN ," SG,SF",254,1106,1376,2016-12-26,852
Chandler Parsons,MEM ," SF,PF",966,396,1371,2016-12-26,-570
Emmanuel Mudiay,DEN , PG,450,886,1345,2016-12-26,436
Elfrid Payton,ORL , PG,97,1209,1318,2016-12-26,1112
Trevor Booker,BKN , PF,869,411,1303,2016-12-26,-458
J.R. Smith,CLE ," SG,SF",1242,60,1303,2016-12-26,-1182
Michael Carter-Williams,CHI , PG,78,1223,1301,2016-12-26,1145
Darren Collison,SAC , PG,1087,165,1264,2016-12-26,-922
Andre Roberson,OKC ," SG,SF",898,361,1261,2016-12-26,-537
Seth Curry,DAL ," PG,SG",482,5345,5828,2016-12-27,4863
Tim Frazier,NO ," PG,SG",4182,142,4329,2016-12-27,-4040
Ty Lawson,SAC , PG,329,3408,3739,2016-12-27,3079
Sean Kilpatrick,BKN ," PG,SG",117,3500,3624,2016-12-27,3383
Michael Kidd-Gilchrist,CHA , SF,169,3408,3580,2016-12-27,3239
Montrezl Harrell,HOU ," PF,C",1504,1939,3444,2016-12-27,435
Tyler Johnson,MIA ," SF,PF",793,2456,3249,2016-12-27,1663
Malcolm Brogdon,MIL ," PG,SG",2766,312,3080,2016-12-27,-2454
Marreese Speights,LAC ," PF,C",2565,405,2975,2016-12-27,-2160
Nikola Mirotic,CHI ," SF,PF",188,2710,2905,2016-12-27,2522
J.J. Barea,DAL ," PG,SG",2454,123,2582,2016-12-27,-2331
Thabo Sefolosha,ATL ," SG,SF",213,2355,2571,2016-12-27,2142
Shelvin Mack,UTA , PG,963,1570,2534,2016-12-27,607
Will Barton,DEN ," SG,SF",98,2344,2450,2016-12-27,2246
Jamal Crawford,LAC ," SG,SF",245,2160,2407,2016-12-27,1915
Tony Allen,MEM ," SG,SF",1636,672,2314,2016-12-27,-964
Dwight Powell,DAL ," PF,C",1863,419,2283,2016-12-27,-1444
Sergio Rodriguez,PHI , PG,161,2114,2278,2016-12-27,1953
Lucas Nogueira,TOR ," PF,C",313,1771,2084,2016-12-27,1458
JaMychal Green,MEM , PF,1798,245,2050,2016-12-27,-1553
John Henson,MIL ," PF,C",1785,181,1969,2016-12-27,-1604
Marco Belinelli,CHA ," SG,SF",1815,37,1855,2016-12-27,-1778
Chandler Parsons,MEM ," SF,PF",1656,126,1788,2016-12-27,-1530
Cody Zeller,CHA ," PF,C",195,1547,1750,2016-12-27,1352
Kent Bazemore,ATL ," SG,SF",1461,135,1600,2016-12-27,-1326
Josh Richardson,MIA ," SG,SF",523,1050,1574,2016-12-27,527
Luol Deng,LAL ," SF,PF",474,1064,1541,2016-12-27,590
Nick Young,LAL ," SG,SF",771,735,1516,2016-12-27,-36
P.J. Tucker,PHO ," SG,SF",1286,178,1465,2016-12-27,-1108
C.J. Miles,IND ," SG,SF",1241,213,1455,2016-12-27,-1028
Marcus Morris,DET ," SF,PF",460,947,1418,2016-12-27,487
Andrew Bogut,DAL , C,255,1095,1352,2016-12-27,840
Andre Roberson,OKC ," SG,SF",1158,191,1349,2016-12-27,-967
Joe Ingles,UTA ," SG,SF",498,835,1334,2016-12-27,337
Justise Winslow,MIA ," SF,PF",567,742,1314,2016-12-27,175
Austin Rivers,LAC ," PG,SG,SF",390,862,1254,2016-12-27,472
Patty Mills,SA , PG,909,340,1253,2016-12-27,-569
Tyler Johnson,MIA ," PG,SG",477,760,1241,2016-12-27,283
Tyson Chandler,PHO , C,1020,196,1225,2016-12-27,-824
Jon Leuer,DET ," PF,C",294,902,1203,2016-12-27,608
Marcus Smart,BOS , PG,436,710,1152,2016-12-27,274
Trevor Booker,BKN , PF,842,296,1151,2016-12-27,-546
Tony Snell,MIL ," SG,SF",26,1108,1134,2016-12-27,1082
Kyle O'Quinn,NY ," PF,C",925,188,1115,2016-12-27,-737
Patrick Patterson,TOR ," PF,C",167,946,1115,2016-12-27,779
Maurice Harkless,POR , SF,777,325,1114,2016-12-27,-452
Gary Harris,DEN ," SG,SF",971,135,1113,2016-12-27,-836
Tyreke Evans,NO ," PG,SG,SF",1010,82,1097,2016-12-27,-928
Raymond Felton,LAC ," PG,SG",859,224,1083,2016-12-27,-635
Bojan Bogdanovic,BKN ," SG,SF",241,827,1080,2016-12-27,586
Josh Richardson,MIA ," SG,SF",160,4422,4583,2016-12-28,4262
Sergio Rodriguez,PHI , PG,160,3525,3686,2016-12-28,3365
Tim Frazier,NO ," PG,SG",3388,118,3514,2016-12-28,-3270
Michael Kidd-Gilchrist,CHA , SF,132,2601,2737,2016-12-28,2469
Montrezl Harrell,HOU ," PF,C",2540,188,2730,2016-12-28,-2352
Seth Curry,DAL ," PG,SG",686,2009,2697,2016-12-28,1323
Jeremy Lin,BKN ," PG,SG",2604,48,2665,2016-12-28,-2556
Tyler Johnson,MIA ," SF,PF",458,2142,2600,2016-12-28,1684
Ty Lawson,SAC , PG,812,1586,2402,2016-12-28,774
Tony Allen,MEM ," SG,SF",355,1953,2312,2016-12-28,1598
Sean Kilpatrick,BKN ," PG,SG",196,1983,2186,2016-12-28,1787
Jamal Crawford,LAC ," SG,SF",997,962,1962,2016-12-28,-35
Monta Ellis,IND ," PG,SG",401,1527,1932,2016-12-28,1126
Marco Belinelli,CHA ," SG,SF",1888,18,1908,2016-12-28,-1870
Marreese Speights,LAC ," PF,C",1531,308,1839,2016-12-28,-1223
Joakim Noah,NY ," PF,C",223,1515,1740,2016-12-28,1292
Cody Zeller,CHA ," PF,C",184,1495,1682,2016-12-28,1311
Thabo Sefolosha,ATL ," SG,SF",468,1167,1641,2016-12-28,699
Will Barton,DEN ," SG,SF",518,1109,1639,2016-12-28,591
Lucas Nogueira,TOR ," PF,C",415,1211,1629,2016-12-28,796
Malcolm Brogdon,MIL ," PG,SG",1117,485,1604,2016-12-28,-632
John Henson,MIL ," PF,C",1428,112,1548,2016-12-28,-1316
Joe Ingles,UTA ," SG,SF",257,1260,1518,2016-12-28,1003
Nikola Mirotic,CHI ," SF,PF",452,1044,1506,2016-12-28,592
Shelvin Mack,UTA , PG,1268,232,1501,2016-12-28,-1036
Nick Young,LAL ," SG,SF",1064,388,1465,2016-12-28,-676
Raymond Felton,LAC ," PG,SG",1371,70,1441,2016-12-28,-1301
Patty Mills,SA , PG,1075,338,1419,2016-12-28,-737
Austin Rivers,LAC ," PG,SG,SF",529,781,1310,2016-12-28,252
JaMychal Green,MEM , PF,1081,217,1302,2016-12-28,-864
Kyle O'Quinn,NY ," PF,C",1100,186,1290,2016-12-28,-914
Marcus Morris,DET ," SF,PF",528,749,1286,2016-12-28,221
Luol Deng,LAL ," SF,PF",456,797,1257,2016-12-28,341
Dwight Powell,DAL ," PF,C",714,433,1149,2016-12-28,-281
Tyler Johnson,MIA ," PG,SG",362,749,1118,2016-12-28,387
Marcus Smart,BOS , PG,324,789,1116,2016-12-28,465
Tyson Chandler,PHO , C,886,216,1113,2016-12-28,-670
Maurice Harkless,POR , SF,862,226,1096,2016-12-28,-636
Chandler Parsons,MEM ," SF,PF",927,141,1070,2016-12-28,-786
Darren Collison,SAC , PG,901,156,1068,2016-12-28,-745
J.J. Barea,DAL ," PG,SG",954,105,1066,2016-12-28,-849
Dirk Nowitzki,DAL ," PF,C",884,169,1063,2016-12-28,-715
Nerlens Noel,PHI ," PF,C",384,642,1035,2016-12-28,258
Kent Bazemore,ATL ," SG,SF",894,127,1028,2016-12-28,-767
Bismack Biyombo,ORL ," PF,C",615,393,1020,2016-12-28,-222
Patrick Patterson,TOR ," PF,C",214,779,996,2016-12-28,565
Jeremy Lamb,CHA ," SG,SF",74,918,992,2016-12-28,844
Jon Leuer,DET ," PF,C",456,520,984,2016-12-28,64
Courtney Lee,NY ," SG,SF",875,79,956,2016-12-28,-796
Andre Roberson,OKC ," SG,SF",886,67,954,2016-12-28,-819
Josh Richardson,MIA ," SG,SF",188,4390,4580,2016-12-29,4202
Sergio Rodriguez,PHI , PG,1996,1941,3945,2016-12-29,-55
Joakim Noah,NY ," PF,C",164,3704,3870,2016-12-29,3540
Tim Frazier,NO ," PG,SG",3558,109,3672,2016-12-29,-3449
Dragan Bender,PHO , PF,262,3405,3667,2016-12-29,3143
Tyreke Evans,NO ," PG,SG,SF",129,2945,3080,2016-12-29,2816
Austin Rivers,LAC ," PG,SG,SF",279,2579,2858,2016-12-29,2300
Malcolm Brogdon,MIL ," PG,SG",462,2219,2684,2016-12-29,1757
Darren Collison,SAC , PG,2546,84,2640,2016-12-29,-2462
Monta Ellis,IND ," PG,SG",470,1923,2396,2016-12-29,1453
Sean Kilpatrick,BKN ," PG,SG",207,2054,2273,2016-12-29,1847
John Henson,MIL ," PF,C",1768,371,2147,2016-12-29,-1397
Jamal Crawford,LAC ," SG,SF",1809,247,2065,2016-12-29,-1562
Thabo Sefolosha,ATL ," SG,SF",419,1475,1898,2016-12-29,1056
Lucas Nogueira,TOR ," PF,C",1609,283,1893,2016-12-29,-1326
Shelvin Mack,UTA , PG,1802,74,1877,2016-12-29,-1728
Tyler Johnson,MIA ," SF,PF",825,1008,1838,2016-12-29,183
Tony Allen,MEM ," SG,SF",590,1225,1822,2016-12-29,635
Michael Kidd-Gilchrist,CHA , SF,890,912,1805,2016-12-29,22
Ty Lawson,SAC , PG,1338,451,1790,2016-12-29,-887
Seth Curry,DAL ," PG,SG",667,1091,1764,2016-12-29,424
Marreese Speights,LAC ," PF,C",854,788,1645,2016-12-29,-66
Luol Deng,LAL ," SF,PF",937,631,1575,2016-12-29,-306
Tony Snell,MIL ," SG,SF",105,1438,1543,2016-12-29,1333
Jeremy Lin,BKN ," PG,SG",1448,64,1534,2016-12-29,-1384
Terrence Ross,TOR ," SG,SF",188,1333,1524,2016-12-29,1145
Patty Mills,SA , PG,1145,318,1470,2016-12-29,-827
Patrick Patterson,TOR ," PF,C",1189,187,1378,2016-12-29,-1002
Justise Winslow,MIA ," SF,PF",1062,282,1350,2016-12-29,-780
Tyson Chandler,PHO , C,1128,174,1317,2016-12-29,-954
Joe Ingles,UTA ," SG,SF",799,497,1297,2016-12-29,-302
Raymond Felton,LAC ," PG,SG",1271,15,1286,2016-12-29,-1256
Montrezl Harrell,HOU ," PF,C",1058,159,1222,2016-12-29,-899
Kyle O'Quinn,NY ," PF,C",902,294,1198,2016-12-29,-608
Will Barton,DEN ," SG,SF",755,425,1192,2016-12-29,-330
Nerlens Noel,PHI ," PF,C",307,869,1188,2016-12-29,562
Buddy Hield,NO , SG,82,1100,1182,2016-12-29,1018
Dirk Nowitzki,DAL ," PF,C",967,160,1139,2016-12-29,-807
JaMychal Green,MEM , PF,720,401,1130,2016-12-29,-319
Marcus Morris,DET ," SF,PF",677,397,1087,2016-12-29,-280
Nikola Mirotic,CHI ," SF,PF",620,454,1079,2016-12-29,-166
Tyler Johnson,MIA ," PG,SG",181,888,1072,2016-12-29,707
T.J. Warren,PHO , SF,269,786,1068,2016-12-29,517
Maurice Harkless,POR , SF,803,243,1061,2016-12-29,-560
Cody Zeller,CHA ," PF,C",535,523,1061,2016-12-29,-12
Danny Green,SA ," SG,SF",260,789,1055,2016-12-29,529
Jon Leuer,DET ," PF,C",572,468,1050,2016-12-29,-104
Alex Len,PHO ," PF,C",708,334,1049,2016-12-29,-374
Chandler Parsons,MEM ," SF,PF",806,217,1040,2016-12-29,-589
Marvin Williams,CHA ," SF,PF",552,483,1040,2016-12-29,-69
Josh Richardson,MIA ," SG,SF",208,6100,6309,2016-12-30,5892
Sergio Rodriguez,PHI , PG,4713,86,4806,2016-12-30,-4627
Malcolm Brogdon,MIL ," PG,SG",332,4315,4650,2016-12-30,3983
JaMychal Green,MEM , PF,247,2819,3077,2016-12-30,2572
Austin Rivers,LAC ," PG,SG,SF",347,2648,2998,2016-12-30,2301
Joakim Noah,NY ," PF,C",571,2283,2861,2016-12-30,1712
Tyreke Evans,NO ," PG,SG,SF",119,2668,2791,2016-12-30,2549
Montrezl Harrell,HOU ," PF,C",509,2201,2715,2016-12-30,1692
Luol Deng,LAL ," SF,PF",2303,199,2508,2016-12-30,-2104
Michael Carter-Williams,CHI , PG,94,2314,2408,2016-12-30,2220
Tony Allen,MEM ," SG,SF",428,1803,2233,2016-12-30,1375
Tim Frazier,NO ," PG,SG",2045,131,2182,2016-12-30,-1914
Seth Curry,DAL ," PG,SG",1644,413,2065,2016-12-30,-1231
Justise Winslow,MIA ," SF,PF",1770,101,1887,2016-12-30,-1669
Thabo Sefolosha,ATL ," SG,SF",835,996,1838,2016-12-30,161
T.J. McConnell,PHI , PG,310,1473,1783,2016-12-30,1163
John Henson,MIL ," PF,C",1353,417,1775,2016-12-30,-936
Tony Snell,MIL ," SG,SF",228,1539,1767,2016-12-30,1311
Tyler Johnson,MIA ," SF,PF",1099,646,1751,2016-12-30,-453
Marreese Speights,LAC ," PF,C",353,1388,1744,2016-12-30,1035
Monta Ellis,IND ," PG,SG",696,995,1698,2016-12-30,299
Marcus Morris,DET ," SF,PF",1419,248,1678,2016-12-30,-1171
Sean Kilpatrick,BKN ," PG,SG",679,928,1620,2016-12-30,249
Shelvin Mack,UTA , PG,1533,18,1554,2016-12-30,-1515
Michael Kidd-Gilchrist,CHA , SF,795,745,1550,2016-12-30,-50
Tyler Johnson,MIA ," PG,SG",161,1336,1506,2016-12-30,1175
Troy Daniels,MEM ," PG,SG",161,1286,1448,2016-12-30,1125
Lucas Nogueira,TOR ," PF,C",1257,105,1364,2016-12-30,-1152
Marvin Williams,CHA ," SF,PF",385,925,1318,2016-12-30,540
Matthew Dellavedova,MIL ," PG,SG",1029,223,1254,2016-12-30,-806
Patty Mills,SA , PG,936,308,1252,2016-12-30,-628
Chandler Parsons,MEM ," SF,PF",1014,224,1245,2016-12-30,-790
Robert Covington,PHI ," SF,PF",1133,102,1243,2016-12-30,-1031
Ty Lawson,SAC , PG,593,645,1240,2016-12-30,52
Dwight Powell,DAL ," PF,C",826,383,1212,2016-12-30,-443
Kyle O'Quinn,NY ," PF,C",853,293,1151,2016-12-30,-560
Patrick Patterson,TOR ," PF,C",1121,18,1145,2016-12-30,-1103
Jeremy Lin,BKN ," PG,SG",1018,101,1137,2016-12-30,-917
Dragan Bender,PHO , PF,578,553,1131,2016-12-30,-25
Marcus Smart,BOS , PG,658,450,1115,2016-12-30,-208
Cody Zeller,CHA ," PF,C",438,657,1104,2016-12-30,219
Jamal Crawford,LAC ," SG,SF",614,475,1099,2016-12-30,-139
Terrence Jones,NO ," SF,PF",972,107,1083,2016-12-30,-865
Nerlens Noel,PHI ," PF,C",401,656,1068,2016-12-30,255
Nick Young,LAL ," SG,SF",485,535,1035,2016-12-30,50
Will Barton,DEN ," SG,SF",694,318,1027,2016-12-30,-376
Darren Collison,SAC , PG,814,185,1016,2016-12-30,-629
Dirk Nowitzki,DAL ," PF,C",772,213,998,2016-12-30,-559
Alex Len,PHO ," PF,C",577,396,978,2016-12-30,-181
Garrett Temple,SAC ," PG,SG",181,790,972,2016-12-30,609
Malcolm Brogdon,MIL ," PG,SG",715,6701,7419,2016-12-31,5986
Josh Richardson,MIA ," SG,SF",164,6113,6286,2016-12-31,5949
Montrezl Harrell,HOU ," PF,C",407,5225,5636,2016-12-31,4818
Michael Carter-Williams,CHI , PG,428,3475,3903,2016-12-31,3047
John Henson,MIL ," PF,C",3690,141,3841,2016-12-31,-3549
Tyler Johnson,MIA ," SF,PF",262,2735,3002,2016-12-31,2473
Rajon Rondo,CHI , PG,2819,86,2929,2016-12-31,-2733
Ty Lawson,SAC , PG,2453,309,2765,2016-12-31,-2144
Marcus Morris,DET ," SF,PF",2466,170,2647,2016-12-31,-2296
Terrence Ross,TOR ," SG,SF",216,2403,2622,2016-12-31,2187
Marreese Speights,LAC ," PF,C",835,1387,2227,2016-12-31,552
Joakim Noah,NY ," PF,C",1641,420,2068,2016-12-31,-1221
Danny Green,SA ," SG,SF",169,1845,2016,2016-12-31,1676
Sergio Rodriguez,PHI , PG,1908,48,1963,2016-12-31,-1860
JaMychal Green,MEM , PF,531,1329,1864,2016-12-31,798
Austin Rivers,LAC ," PG,SG,SF",1533,324,1858,2016-12-31,-1209
Tyreke Evans,NO ," PG,SG,SF",126,1721,1856,2016-12-31,1595
Thomas Robinson,LAL ," PF,C",57,1783,1840,2016-12-31,1726
K. Korver,CLE ," SG,SF",123,1690,1816,2016-12-31,1567
Tim Frazier,NO ," PG,SG",1703,60,1769,2016-12-31,-1643
Tony Parker,SA , PG,158,1596,1756,2016-12-31,1438
Tyler Johnson,MIA ," PG,SG",143,1556,1712,2016-12-31,1413
Jon Leuer,DET ," PF,C",141,1547,1698,2016-12-31,1406
Jamal Crawford,LAC ," SG,SF",1469,203,1674,2016-12-31,-1266
Seth Curry,DAL ," PG,SG",1384,281,1671,2016-12-31,-1103
Tony Allen,MEM ," SG,SF",1163,493,1660,2016-12-31,-670
Kyle O'Quinn,NY ," PF,C",1506,66,1579,2016-12-31,-1440
Thabo Sefolosha,ATL ," SG,SF",976,507,1491,2016-12-31,-469
Allen Crabbe,POR ," PG,SG",224,1141,1365,2016-12-31,917
Terrence Jones,NO ," SF,PF",1320,27,1350,2016-12-31,-1293
Lucas Nogueira,TOR ," PF,C",513,826,1339,2016-12-31,313
Monta Ellis,IND ," PG,SG",1027,307,1338,2016-12-31,-720
Raymond Felton,LAC ," PG,SG",219,1105,1326,2016-12-31,886
Patty Mills,SA , PG,867,434,1305,2016-12-31,-433
Luol Deng,LAL ," SF,PF",927,351,1285,2016-12-31,-576
Matthew Dellavedova,MIL ," PG,SG",1247,13,1262,2016-12-31,-1234
Maurice Harkless,POR , SF,595,630,1243,2016-12-31,35
T.J. Warren,PHO , SF,1062,160,1236,2016-12-31,-902
Cody Zeller,CHA ," PF,C",832,388,1232,2016-12-31,-444
Sean Kilpatrick,BKN ," PG,SG",1007,207,1224,2016-12-31,-800
Nikola Mirotic,CHI ," SF,PF",862,335,1204,2016-12-31,-527
Michael Kidd-Gilchrist,CHA , SF,778,408,1201,2016-12-31,-370
Darren Collison,SAC , PG,600,553,1171,2016-12-31,-47
Dwight Powell,DAL ," PF,C",375,790,1166,2016-12-31,415
Tony Snell,MIL ," SG,SF",1047,101,1149,2016-12-31,-946
Wayne Ellington,MIA ," SG,SF",127,1010,1137,2016-12-31,883
Marvin Williams,CHA ," SF,PF",571,548,1127,2016-12-31,-23
C.J. Miles,IND ," SG,SF",684,428,1119,2016-12-31,-256
Nick Young,LAL ," SG,SF",311,794,1117,2016-12-31,483
Bismack Biyombo,ORL ," PF,C",348,761,1116,2016-12-31,413
Malcolm Brogdon,MIL ," PG,SG",142,12046,12191,2017-01-01,11904
Marreese Speights,LAC ," PF,C",443,3455,3904,2017-01-01,3012
Montrezl Harrell,HOU ," PF,C",623,3222,3848,2017-01-01,2599
Rajon Rondo,CHI , PG,3545,82,3661,2017-01-01,-3463
John Henson,MIL ," PF,C",3293,61,3358,2017-01-01,-3232
Justin Holiday,NY ," SG,SF",93,3052,3145,2017-01-01,2959
Josh Richardson,MIA ," SG,SF",251,2841,3098,2017-01-01,2590
JaMychal Green,MEM , PF,239,2542,2788,2017-01-01,2303
Tyler Johnson,MIA ," SF,PF",311,2361,2679,2017-01-01,2050
Luol Deng,LAL ," SF,PF",2104,416,2526,2017-01-01,-1688
Ty Lawson,SAC , PG,2353,55,2411,2017-01-01,-2298
Michael Carter-Williams,CHI , PG,480,1846,2326,2017-01-01,1366
Tony Parker,SA , PG,311,1772,2084,2017-01-01,1461
Terrence Ross,TOR ," SG,SF",694,1386,2081,2017-01-01,692
Jamal Crawford,LAC ," SG,SF",1769,138,1915,2017-01-01,-1631
Thabo Sefolosha,ATL ," SG,SF",1516,355,1878,2017-01-01,-1161
T.J. Warren,PHO , SF,1682,87,1785,2017-01-01,-1595
Thomas Robinson,LAL ," PF,C",354,1371,1725,2017-01-01,1017
Patty Mills,SA , PG,1384,295,1691,2017-01-01,-1089
Jon Leuer,DET ," PF,C",753,869,1631,2017-01-01,116
K. Korver,CLE ," SG,SF",286,1260,1553,2017-01-01,974
Joakim Noah,NY ," PF,C",388,1148,1543,2017-01-01,760
Justise Winslow,MIA ," SF,PF",1291,195,1500,2017-01-01,-1096
Danny Green,SA ," SG,SF",508,949,1462,2017-01-01,441
Tyler Johnson,MIA ," PG,SG",224,1211,1451,2017-01-01,987
Darren Collison,SAC , PG,297,1130,1443,2017-01-01,833
Brandon Jennings,NY , PG,127,1285,1415,2017-01-01,1158
Lucas Nogueira,TOR ," PF,C",849,549,1403,2017-01-01,-300
C.J. Miles,IND ," SG,SF",1098,254,1355,2017-01-01,-844
Brandon Knight,PHO ," PG,SG",1243,86,1343,2017-01-01,-1157
Marcus Morris,DET ," SF,PF",1051,273,1330,2017-01-01,-778
Michael Kidd-Gilchrist,CHA , SF,532,784,1322,2017-01-01,252
Tony Allen,MEM ," SG,SF",962,347,1317,2017-01-01,-615
Maurice Harkless,POR , SF,794,508,1314,2017-01-01,-286
Tim Frazier,NO ," PG,SG",1176,133,1313,2017-01-01,-1043
Austin Rivers,LAC ," PG,SG,SF",925,350,1278,2017-01-01,-575
Monta Ellis,IND ," PG,SG",976,292,1272,2017-01-01,-684
Sergio Rodriguez,PHI , PG,1126,105,1242,2017-01-01,-1021
Kent Bazemore,ATL ," SG,SF",916,315,1236,2017-01-01,-601
Wayne Ellington,MIA ," SG,SF",247,975,1222,2017-01-01,728
Nick Young,LAL ," SG,SF",353,820,1186,2017-01-01,467
Cody Zeller,CHA ," PF,C",855,300,1168,2017-01-01,-555
Emmanuel Mudiay,DEN , PG,168,934,1119,2017-01-01,766
Tyreke Evans,NO ," PG,SG,SF",125,984,1118,2017-01-01,859
Allen Crabbe,POR ," PG,SG",522,593,1116,2017-01-01,71
Marvin Williams,CHA ," SF,PF",505,600,1112,2017-01-01,95
Seth Curry,DAL ," PG,SG",736,369,1110,2017-01-01,-367
Al-Farouq Aminu,POR ," SF,PF",515,547,1063,2017-01-01,32
Bismack Biyombo,ORL ," PF,C",411,631,1054,2017-01-01,220
Alex Len,PHO ," PF,C",817,227,1049,2017-01-01,-590
Malcolm Brogdon,MIL ," PG,SG",415,8074,8492,2017-01-02,7659
Tyler Johnson,MIA ," SF,PF",234,5805,6047,2017-01-02,5571
Tony Parker,SA , PG,282,5546,5830,2017-01-02,5264
Rajon Rondo,CHI , PG,5372,254,5656,2017-01-02,-5118
JaMychal Green,MEM , PF,152,4404,4566,2017-01-02,4252
Luol Deng,LAL ," SF,PF",4277,201,4482,2017-01-02,-4076
Michael Carter-Williams,CHI , PG,443,3929,4374,2017-01-02,3486
Justin Holiday,NY ," SG,SF",1286,2851,4137,2017-01-02,1565
Cody Zeller,CHA ," PF,C",3579,265,3855,2017-01-02,-3314
Montrezl Harrell,HOU ," PF,C",455,3326,3785,2017-01-02,2871
Marreese Speights,LAC ," PF,C",643,3136,3782,2017-01-02,2493
Matt Barnes,SAC ," SG,SF",151,3244,3396,2017-01-02,3093
Thabo Sefolosha,ATL ," SG,SF",3131,145,3283,2017-01-02,-2986
Josh Richardson,MIA ," SG,SF",288,2721,3016,2017-01-02,2433
Dwight Powell,DAL ," PF,C",236,2548,2789,2017-01-02,2312
Wayne Ellington,MIA ," SG,SF",207,2506,2715,2017-01-02,2299
Justise Winslow,MIA ," SF,PF",2572,98,2676,2017-01-02,-2474
Joakim Noah,NY ," PF,C",351,1891,2250,2017-01-02,1540
Nick Young,LAL ," SG,SF",195,1930,2148,2017-01-02,1735
Terrence Ross,TOR ," SG,SF",886,1218,2104,2017-01-02,332
John Henson,MIL ," PF,C",1972,99,2079,2017-01-02,-1873
Tyler Johnson,MIA ," PG,SG",299,1766,2071,2017-01-02,1467
Seth Curry,DAL ," PG,SG",689,1355,2047,2017-01-02,666
T.J. McConnell,PHI , PG,176,1857,2033,2017-01-02,1681
Tim Frazier,NO ," PG,SG",1784,221,2012,2017-01-02,-1563
Patty Mills,SA , PG,1689,310,2009,2017-01-02,-1379
Michael Kidd-Gilchrist,CHA , SF,972,1025,2003,2017-01-02,53
K. Korver,CLE ," SG,SF",338,1630,1973,2017-01-02,1292
Ty Lawson,SAC , PG,1870,94,1965,2017-01-02,-1776
Darren Collison,SAC , PG,330,1616,1955,2017-01-02,1286
Sergio Rodriguez,PHI , PG,1750,192,1947,2017-01-02,-1558
Sean Kilpatrick,BKN ," PG,SG",1342,570,1923,2017-01-02,-772
Buddy Hield,NO , SG,206,1695,1904,2017-01-02,1489
Dario Saric,PHI ," SF,PF",190,1657,1851,2017-01-02,1467
Tony Allen,MEM ," SG,SF",603,1229,1836,2017-01-02,626
Brandon Jennings,NY , PG,421,1377,1801,2017-01-02,956
Emmanuel Mudiay,DEN , PG,243,1533,1785,2017-01-02,1290
Thomas Robinson,LAL ," PF,C",394,1274,1668,2017-01-02,880
Marvin Williams,CHA ," SF,PF",760,873,1639,2017-01-02,113
Terrence Jones,NO ," SF,PF",1482,134,1624,2017-01-02,-1348
Marcus Morris,DET ," SF,PF",1211,399,1617,2017-01-02,-812
Monta Ellis,IND ," PG,SG",1016,594,1614,2017-01-02,-422
Bismack Biyombo,ORL ," PF,C",1273,281,1562,2017-01-02,-992
Jon Leuer,DET ," PF,C",972,558,1539,2017-01-02,-414
Kent Bazemore,ATL ," SG,SF",1383,121,1511,2017-01-02,-1262
Jusuf Nurkic,DEN , C,397,1108,1507,2017-01-02,711
Austin Rivers,LAC ," PG,SG,SF",898,609,1507,2017-01-02,-289
Ersan Ilyasova,PHI ," SF,PF",53,1429,1494,2017-01-02,1376
Lucas Nogueira,TOR ," PF,C",1098,381,1482,2017-01-02,-717
Kenneth Faried,DEN ," PF,C",1192,234,1439,2017-01-02,-958
